Region,Departement,COM_ARRT_VILLE,COMMUNE,QUARTIER_VILLAGE_HAMEAU,CONCESSION,MENAGE,HOMMES,FEMMES,POPULATION
DAKAR,GUEDIAWAYE,"VILLE DE GUEDIAWAYE","GOLF SUD","CITE DU GOLF DE CAMBERENE (CITE ALIOUNE SOW)",861,1216,3251,4034,7285
DAKAR,GUEDIAWAYE,"VILLE DE GUEDIAWAYE","GOLF SUD","CITE ATEPA",40,106,257,304,561
DAKAR,GUEDIAWAYE,"VILLE DE GUEDIAWAYE","GOLF SUD","CITE DES ENSEIGNANTS",239,308,975,1125,2100
DAKAR,GUEDIAWAYE,"VILLE DE GUEDIAWAYE","GOLF SUD","CITE DOUANES",173,314,908,964,1872
DAKAR,GUEDIAWAYE,"VILLE DE GUEDIAWAYE","GOLF SUD","CITE FADIA",345,902,2468,2630,5098
DAKAR,GUEDIAWAYE,"VILLE DE GUEDIAWAYE","GOLF SUD","CITE FAYECAL",47,49,128,155,283
DAKAR,GUEDIAWAYE,"VILLE DE GUEDIAWAYE","GOLF SUD","CITE IBRAHIMA DIOP",91,121,403,452,855
DAKAR,GUEDIAWAYE,"VILLE DE GUEDIAWAYE","GOLF SUD","CITE SHS",289,405,1248,1385,2633
DAKAR,GUEDIAWAYE,"VILLE DE GUEDIAWAYE","GOLF SUD","FITH MITH",603,1573,4519,4674,9193
DAKAR,GUEDIAWAYE,"VILLE DE GUEDIAWAYE","GOLF SUD","GUENTABA I",247,768,2052,2170,4222
DAKAR,GUEDIAWAYE,"VILLE DE GUEDIAWAYE","GOLF SUD","GUENTABA II",200,684,1569,1701,3270
DAKAR,GUEDIAWAYE,"VILLE DE GUEDIAWAYE","GOLF SUD","GUENTABA III",483,1361,3554,3958,7512
DAKAR,GUEDIAWAYE,"VILLE DE GUEDIAWAYE","GOLF SUD","HAMO I",170,293,907,1024,1931
DAKAR,GUEDIAWAYE,"VILLE DE GUEDIAWAYE","GOLF SUD","HAMO II",212,423,1131,1231,2362
DAKAR,GUEDIAWAYE,"VILLE DE GUEDIAWAYE","GOLF SUD","HAMO III",171,247,685,811,1496
DAKAR,GUEDIAWAYE,"VILLE DE GUEDIAWAYE","GOLF SUD","HLM LAS PALMAS BLOC I",94,121,403,484,887
DAKAR,GUEDIAWAYE,"VILLE DE GUEDIAWAYE","GOLF SUD","HLM LAS PALMAS BLOC II",113,134,511,534,1045
DAKAR,GUEDIAWAYE,"VILLE DE GUEDIAWAYE","GOLF SUD","HLM LAS PALMAS BLOC III",356,449,1554,1740,3294
DAKAR,GUEDIAWAYE,"VILLE DE GUEDIAWAYE","GOLF SUD","PARCELLES ASSAINIES UNITE I",389,1005,3240,3017,6257
DAKAR,GUEDIAWAYE,"VILLE DE GUEDIAWAYE","GOLF SUD","PARCELLES ASSAINIES UNITE II",349,893,2550,2451,5001
DAKAR,GUEDIAWAYE,"VILLE DE GUEDIAWAYE","GOLF SUD","PARCELLES ASSAINIES UNITE III",295,784,2459,2380,4839
DAKAR,GUEDIAWAYE,"VILLE DE GUEDIAWAYE","GOLF SUD","PARCELLES ASSAINIES UNITE IV",374,976,2903,3045,5948
DAKAR,GUEDIAWAYE,"VILLE DE GUEDIAWAYE","GOLF SUD","PARCELLES ASSAINIES UNITE V",435,1318,4180,3797,7977
DAKAR,GUEDIAWAYE,"VILLE DE GUEDIAWAYE","GOLF SUD","PARCELLES ASSAINIES UNITE VI",491,1582,4463,4314,8777
DAKAR,GUEDIAWAYE,"VILLE DE GUEDIAWAYE","GOLF SUD","RASS MISSION",374,927,2903,2814,5717
DAKAR,GUEDIAWAYE,"VILLE DE GUEDIAWAYE","GOLF SUD","STATION X",311,671,1733,1990,3723
DAKAR,GUEDIAWAYE,"VILLE DE GUEDIAWAYE","GOLF SUD",TAIBA,184,438,1306,1372,2678
DAKAR,GUEDIAWAYE,"VILLE DE GUEDIAWAYE","GOLF SUD","TECHNOPOLE NIAYES",49,79,194,163,357
DAKAR,GUEDIAWAYE,"VILLE DE GUEDIAWAYE","GOLF SUD","CHAMPS DE COURSE B",155,394,1226,1293,2519
DAKAR,GUEDIAWAYE,"VILLE DE GUEDIAWAYE","GOLF SUD","CHAMPS DE COURSE D",138,404,1033,1088,2121
DAKAR,GUEDIAWAYE,"VILLE DE GUEDIAWAYE","GOLF SUD","CITE DALAL JAMM",86,167,350,449,799
DAKAR,GUEDIAWAYE,"VILLE DE GUEDIAWAYE","GOLF SUD","CITE LITTORAL",130,299,661,796,1457
DAKAR,GUEDIAWAYE,"VILLE DE GUEDIAWAYE","SAM NOTAIRE","CITE ADAMA DIOP",85,122,357,431,788
DAKAR,GUEDIAWAYE,"VILLE DE GUEDIAWAYE","SAM NOTAIRE","CITE BARRY ET LY",167,287,991,1003,1994
DAKAR,GUEDIAWAYE,"VILLE DE GUEDIAWAYE","SAM NOTAIRE","CITE HAMO TEFESS",55,83,264,318,582
DAKAR,GUEDIAWAYE,"VILLE DE GUEDIAWAYE","SAM NOTAIRE","CITE URBANISME",87,144,477,410,887
DAKAR,GUEDIAWAYE,"VILLE DE GUEDIAWAYE","SAM NOTAIRE","DAROU MINAM",207,373,1474,1453,2927
DAKAR,GUEDIAWAYE,"VILLE DE GUEDIAWAYE","SAM NOTAIRE","DAROU SALAM I",353,730,2586,2701,5287
DAKAR,GUEDIAWAYE,"VILLE DE GUEDIAWAYE","SAM NOTAIRE","DAROU SALAM II",225,518,1607,1637,3244
DAKAR,GUEDIAWAYE,"VILLE DE GUEDIAWAYE","SAM NOTAIRE",DIAMAGUENE,105,213,832,807,1639
DAKAR,GUEDIAWAYE,"VILLE DE GUEDIAWAYE","SAM NOTAIRE","GIBRALTAR I",361,717,2593,2715,5308
DAKAR,GUEDIAWAYE,"VILLE DE GUEDIAWAYE","SAM NOTAIRE","GIBRALTAR II",150,281,1010,1063,2073
DAKAR,GUEDIAWAYE,"VILLE DE GUEDIAWAYE","SAM NOTAIRE","GOLF NORD EST",145,331,1121,1051,2172
DAKAR,GUEDIAWAYE,"VILLE DE GUEDIAWAYE","SAM NOTAIRE","GOLF NORD I",203,471,1566,1689,3255
DAKAR,GUEDIAWAYE,"VILLE DE GUEDIAWAYE","SAM NOTAIRE","GOLF NORD I BIS",103,498,1021,950,1971
DAKAR,GUEDIAWAYE,"VILLE DE GUEDIAWAYE","SAM NOTAIRE","GOLF NORD II",161,344,1195,1117,2312
DAKAR,GUEDIAWAYE,"VILLE DE GUEDIAWAYE","SAM NOTAIRE","GOLF NORD II VDN",44,69,243,239,482
DAKAR,GUEDIAWAYE,"VILLE DE GUEDIAWAYE","SAM NOTAIRE","GUEULE TAPEE II",160,274,1168,1093,2261
DAKAR,GUEDIAWAYE,"VILLE DE GUEDIAWAYE","SAM NOTAIRE","HLM PARIS",189,341,1119,1209,2328
DAKAR,GUEDIAWAYE,"VILLE DE GUEDIAWAYE","SAM NOTAIRE","MBODE I",174,411,1466,1545,3011
DAKAR,GUEDIAWAYE,"VILLE DE GUEDIAWAYE","SAM NOTAIRE","MBODE II",216,410,1450,1567,3017
DAKAR,GUEDIAWAYE,"VILLE DE GUEDIAWAYE","SAM NOTAIRE","MBODE III",216,392,1625,1465,3090
DAKAR,GUEDIAWAYE,"VILLE DE GUEDIAWAYE","SAM NOTAIRE","MBODE IV",216,438,1766,1737,3503
DAKAR,GUEDIAWAYE,"VILLE DE GUEDIAWAYE","SAM NOTAIRE","MBODE V",202,448,1583,1533,3116
DAKAR,GUEDIAWAYE,"VILLE DE GUEDIAWAYE","SAM NOTAIRE","MBODE VI A",89,188,633,640,1273
DAKAR,GUEDIAWAYE,"VILLE DE GUEDIAWAYE","SAM NOTAIRE","MBODE VI A BIS",199,391,1370,1437,2807
DAKAR,GUEDIAWAYE,"VILLE DE GUEDIAWAYE","SAM NOTAIRE","MBODE VI B",286,554,2273,2220,4493
DAKAR,GUEDIAWAYE,"VILLE DE GUEDIAWAYE","SAM NOTAIRE","NOTAIRE EST",103,201,746,685,1431
DAKAR,GUEDIAWAYE,"VILLE DE GUEDIAWAYE","SAM NOTAIRE","NOTAIRE NORD",165,317,1056,1163,2219
DAKAR,GUEDIAWAYE,"VILLE DE GUEDIAWAYE","SAM NOTAIRE","NOTAIRE OUEST",154,269,1053,1083,2136
DAKAR,GUEDIAWAYE,"VILLE DE GUEDIAWAYE","SAM NOTAIRE","NOTAIRE SUD",139,254,916,1029,1945
DAKAR,GUEDIAWAYE,"VILLE DE GUEDIAWAYE","SAM NOTAIRE",PYROTECHNIQUE,116,318,943,974,1917
DAKAR,GUEDIAWAYE,"VILLE DE GUEDIAWAYE","SAM NOTAIRE","SAM GUEDIAWAYE",83,168,553,556,1109
DAKAR,GUEDIAWAYE,"VILLE DE GUEDIAWAYE","SAM NOTAIRE","GOLF NORD II B",118,247,903,918,1821
DAKAR,GUEDIAWAYE,"VILLE DE GUEDIAWAYE","SAM NOTAIRE","GOLF NORD TERANGA",90,224,743,749,1492
DAKAR,GUEDIAWAYE,"VILLE DE GUEDIAWAYE","SAM NOTAIRE","GUEULE TAPEE II A",193,356,1305,1371,2676
DAKAR,GUEDIAWAYE,"VILLE DE GUEDIAWAYE","MEDINA GOUNASS","BAGDAD I",132,208,1015,813,1828
DAKAR,GUEDIAWAYE,"VILLE DE GUEDIAWAYE","MEDINA GOUNASS","BAGDAD II",63,93,453,428,881
DAKAR,GUEDIAWAYE,"VILLE DE GUEDIAWAYE","MEDINA GOUNASS","CHAMPS DE COURSES",146,283,983,1033,2016
DAKAR,GUEDIAWAYE,"VILLE DE GUEDIAWAYE","MEDINA GOUNASS","DAROU RAHMANE IV A",116,237,941,909,1850
DAKAR,GUEDIAWAYE,"VILLE DE GUEDIAWAYE","MEDINA GOUNASS","DEMBA SOW (PARC)",272,533,1898,1855,3753
DAKAR,GUEDIAWAYE,"VILLE DE GUEDIAWAYE","MEDINA GOUNASS","LANSAR II C",105,253,1020,792,1812
DAKAR,GUEDIAWAYE,"VILLE DE GUEDIAWAYE","MEDINA GOUNASS","MEDINA GOUNASS AB BIS",74,148,513,483,996
DAKAR,GUEDIAWAYE,"VILLE DE GUEDIAWAYE","MEDINA GOUNASS","MEDINA GOUNASS I A",69,170,534,512,1046
DAKAR,GUEDIAWAYE,"VILLE DE GUEDIAWAYE","MEDINA GOUNASS","MEDINA GOUNASS I B V",56,131,412,353,765
DAKAR,GUEDIAWAYE,"VILLE DE GUEDIAWAYE","MEDINA GOUNASS","MEDINA GOUNASS I C",239,409,1692,1670,3362
DAKAR,GUEDIAWAYE,"VILLE DE GUEDIAWAYE","MEDINA GOUNASS","MEDINA GOUNASS II",109,220,788,705,1493
DAKAR,GUEDIAWAYE,"VILLE DE GUEDIAWAYE","MEDINA GOUNASS","MEDINA GOUNASS II B",96,173,852,706,1558
DAKAR,GUEDIAWAYE,"VILLE DE GUEDIAWAYE","MEDINA GOUNASS","MEDINA GOUNASS II BIS",192,310,1487,1366,2853
DAKAR,GUEDIAWAYE,"VILLE DE GUEDIAWAYE","MEDINA GOUNASS","MEDINA GOUNASS III",139,239,1047,968,2015
DAKAR,GUEDIAWAYE,"VILLE DE GUEDIAWAYE","MEDINA GOUNASS","MEDINA GOUNASS III B",112,188,743,630,1373
DAKAR,GUEDIAWAYE,"VILLE DE GUEDIAWAYE","MEDINA GOUNASS","MEDINA GOUNASS IV A",161,246,1016,1008,2024
DAKAR,GUEDIAWAYE,"VILLE DE GUEDIAWAYE","MEDINA GOUNASS","SANT YALLA II",96,159,654,626,1280
DAKAR,GUEDIAWAYE,"VILLE DE GUEDIAWAYE","MEDINA GOUNASS","SANT YALLA II BIS",84,129,517,452,969
DAKAR,GUEDIAWAYE,"VILLE DE GUEDIAWAYE","MEDINA GOUNASS","MEDINA GOUNASS II C",98,127,612,619,1231
DAKAR,GUEDIAWAYE,"VILLE DE GUEDIAWAYE","MEDINA GOUNASS","MEDINA GOUNASS II C BIS",104,262,975,879,1854
DAKAR,GUEDIAWAYE,"VILLE DE GUEDIAWAYE","MEDINA GOUNASS","MEDINA GOUNASS II I BIS",59,106,367,355,722
DAKAR,GUEDIAWAYE,"VILLE DE GUEDIAWAYE","MEDINA GOUNASS","MEDINA GOUNASS IV",64,126,507,400,907
DAKAR,GUEDIAWAYE,"VILLE DE GUEDIAWAYE","NDIAREME LIMAMOULAYE","ANGLE MOUSSE DAROU NAHIM",138,305,1048,1078,2126
DAKAR,GUEDIAWAYE,"VILLE DE GUEDIAWAYE","NDIAREME LIMAMOULAYE","ANGLE MOUSSE II",221,497,1581,1660,3241
DAKAR,GUEDIAWAYE,"VILLE DE GUEDIAWAYE","NDIAREME LIMAMOULAYE","ANGLE MOUSSE III",97,282,777,757,1534
DAKAR,GUEDIAWAYE,"VILLE DE GUEDIAWAYE","NDIAREME LIMAMOULAYE","HAMO IV",363,478,1562,1812,3374
DAKAR,GUEDIAWAYE,"VILLE DE GUEDIAWAYE","NDIAREME LIMAMOULAYE","HAMO V",207,286,932,1010,1942
DAKAR,GUEDIAWAYE,"VILLE DE GUEDIAWAYE","NDIAREME LIMAMOULAYE","HAMO VI",328,472,1464,1707,3171
DAKAR,GUEDIAWAYE,"VILLE DE GUEDIAWAYE","NDIAREME LIMAMOULAYE","NDIAREME I",52,112,436,380,816
DAKAR,GUEDIAWAYE,"VILLE DE GUEDIAWAYE","NDIAREME LIMAMOULAYE","NIMZAT II SANTE YALLA",131,270,920,920,1840
DAKAR,GUEDIAWAYE,"VILLE DE GUEDIAWAYE","NDIAREME LIMAMOULAYE","NIMZAT III",149,321,1181,1194,2375
DAKAR,GUEDIAWAYE,"VILLE DE GUEDIAWAYE","NDIAREME LIMAMOULAYE","NIMZAT NDIOLOFENE",289,521,1956,2031,3987
DAKAR,GUEDIAWAYE,"VILLE DE GUEDIAWAYE","NDIAREME LIMAMOULAYE","NIMZAT TAPITO",226,416,1616,1573,3189
DAKAR,GUEDIAWAYE,"VILLE DE GUEDIAWAYE","NDIAREME LIMAMOULAYE","NIMZAT V",66,125,526,511,1037
DAKAR,GUEDIAWAYE,"VILLE DE GUEDIAWAYE","NDIAREME LIMAMOULAYE",ADK,64,97,339,318,657
DAKAR,GUEDIAWAYE,"VILLE DE GUEDIAWAYE","NDIAREME LIMAMOULAYE","ANGLE MOUSSE I",82,182,675,655,1330
DAKAR,GUEDIAWAYE,"VILLE DE GUEDIAWAYE","NDIAREME LIMAMOULAYE","CITE BARACK",28,34,237,175,412
DAKAR,GUEDIAWAYE,"VILLE DE GUEDIAWAYE","NDIAREME LIMAMOULAYE",NDIAREME,35,78,297,302,599
DAKAR,GUEDIAWAYE,"VILLE DE GUEDIAWAYE","NDIAREME LIMAMOULAYE","NDIAREME II",98,168,730,776,1506
DAKAR,GUEDIAWAYE,"VILLE DE GUEDIAWAYE","NDIAREME LIMAMOULAYE","NIMZAT II",49,96,359,337,696
DAKAR,GUEDIAWAYE,"VILLE DE GUEDIAWAYE","NDIAREME LIMAMOULAYE","NIMZAT II SANTE YALLA II",75,137,510,530,1040
DAKAR,GUEDIAWAYE,"VILLE DE GUEDIAWAYE","NDIAREME LIMAMOULAYE","NIMZAT II YAKAAR",48,85,352,373,725
DAKAR,GUEDIAWAYE,"VILLE DE GUEDIAWAYE","NDIAREME LIMAMOULAYE","NIMZAT V BIS",28,52,224,203,427
DAKAR,GUEDIAWAYE,"VILLE DE GUEDIAWAYE","WAKHINANE NIMZATT",ALMINKO,85,208,697,664,1361
DAKAR,GUEDIAWAYE,"VILLE DE GUEDIAWAYE","WAKHINANE NIMZATT","ANGLE MOUSS II",273,525,1821,1852,3673
DAKAR,GUEDIAWAYE,"VILLE DE GUEDIAWAYE","WAKHINANE NIMZATT","BAYE LAYE",326,742,2558,2430,4988
DAKAR,GUEDIAWAYE,"VILLE DE GUEDIAWAYE","WAKHINANE NIMZATT","CITE AIR AFRIQUE",90,162,577,561,1138
DAKAR,GUEDIAWAYE,"VILLE DE GUEDIAWAYE","WAKHINANE NIMZATT","CITE BIAGUI",76,106,283,287,570
DAKAR,GUEDIAWAYE,"VILLE DE GUEDIAWAYE","WAKHINANE NIMZATT","CITE CAISSE DE SECURITE SOCIALE",56,72,198,221,419
DAKAR,GUEDIAWAYE,"VILLE DE GUEDIAWAYE","WAKHINANE NIMZATT","CITE COMICO II",220,423,1363,1400,2763
DAKAR,GUEDIAWAYE,"VILLE DE GUEDIAWAYE","WAKHINANE NIMZATT","CITE COUR SUPREME",52,111,312,345,657
DAKAR,GUEDIAWAYE,"VILLE DE GUEDIAWAYE","WAKHINANE NIMZATT","CITE DARE SALAM",72,136,396,494,890
DAKAR,GUEDIAWAYE,"VILLE DE GUEDIAWAYE","WAKHINANE NIMZATT","CITE GADAYE",255,360,1287,1342,2629
DAKAR,GUEDIAWAYE,"VILLE DE GUEDIAWAYE","WAKHINANE NIMZATT","CITE JUSTICE",52,61,234,288,522
DAKAR,GUEDIAWAYE,"VILLE DE GUEDIAWAYE","WAKHINANE NIMZATT","CITE MADIENG KHARY DIENG",42,64,313,263,576
DAKAR,GUEDIAWAYE,"VILLE DE GUEDIAWAYE","WAKHINANE NIMZATT","CITE MARCEL MAHE",13,15,66,84,150
DAKAR,GUEDIAWAYE,"VILLE DE GUEDIAWAYE","WAKHINANE NIMZATT","CITE MINISTERE COOPERATIVE ET PLAN",30,57,155,182,337
DAKAR,GUEDIAWAYE,"VILLE DE GUEDIAWAYE","WAKHINANE NIMZATT","CITE CHERIF MACKY SALL EX MUNUCIPALITE",207,346,1076,1064,2140
DAKAR,GUEDIAWAYE,"VILLE DE GUEDIAWAYE","WAKHINANE NIMZATT","CITE RONDON",28,55,192,191,383
DAKAR,GUEDIAWAYE,"VILLE DE GUEDIAWAYE","WAKHINANE NIMZATT","CITE SANTE",80,150,492,510,1002
DAKAR,GUEDIAWAYE,"VILLE DE GUEDIAWAYE","WAKHINANE NIMZATT","CITE SAR",91,249,752,728,1480
DAKAR,GUEDIAWAYE,"VILLE DE GUEDIAWAYE","WAKHINANE NIMZATT","CITE SONES",97,132,524,543,1067
DAKAR,GUEDIAWAYE,"VILLE DE GUEDIAWAYE","WAKHINANE NIMZATT","CITE SENELEC",78,154,521,556,1077
DAKAR,GUEDIAWAYE,"VILLE DE GUEDIAWAYE","WAKHINANE NIMZATT","CITE SENTENAC",115,150,494,551,1045
DAKAR,GUEDIAWAYE,"VILLE DE GUEDIAWAYE","WAKHINANE NIMZATT","CITE SOFRACO",95,117,339,397,736
DAKAR,GUEDIAWAYE,"VILLE DE GUEDIAWAYE","WAKHINANE NIMZATT","CITE SORES",86,239,794,738,1532
DAKAR,GUEDIAWAYE,"VILLE DE GUEDIAWAYE","WAKHINANE NIMZATT","CITE TRESOR",96,189,633,660,1293
DAKAR,GUEDIAWAYE,"VILLE DE GUEDIAWAYE","WAKHINANE NIMZATT","DAROU KHOUDOSS",134,281,1104,1029,2133
DAKAR,GUEDIAWAYE,"VILLE DE GUEDIAWAYE","WAKHINANE NIMZATT","DAROU RAHMANE II",174,323,1339,1186,2525
DAKAR,GUEDIAWAYE,"VILLE DE GUEDIAWAYE","WAKHINANE NIMZATT","DAROU RAHMANE IV",239,414,1753,1593,3346
DAKAR,GUEDIAWAYE,"VILLE DE GUEDIAWAYE","WAKHINANE NIMZATT","DAROU RAHMANE VI",39,44,228,233,461
DAKAR,GUEDIAWAYE,"VILLE DE GUEDIAWAYE","WAKHINANE NIMZATT","DAROU RAHMANE VII",96,144,610,648,1258
DAKAR,GUEDIAWAYE,"VILLE DE GUEDIAWAYE","WAKHINANE NIMZATT","DAROU RAHMANE VIII",88,131,680,607,1287
DAKAR,GUEDIAWAYE,"VILLE DE GUEDIAWAYE","WAKHINANE NIMZATT","DAROU SALAM",284,570,2048,1925,3973
DAKAR,GUEDIAWAYE,"VILLE DE GUEDIAWAYE","WAKHINANE NIMZATT","DAROUKHANE I",116,258,920,912,1832
DAKAR,GUEDIAWAYE,"VILLE DE GUEDIAWAYE","WAKHINANE NIMZATT","DAROUKHANE II",244,461,1728,1675,3403
DAKAR,GUEDIAWAYE,"VILLE DE GUEDIAWAYE","WAKHINANE NIMZATT",KAWSARA,226,468,1749,1680,3429
DAKAR,GUEDIAWAYE,"VILLE DE GUEDIAWAYE","WAKHINANE NIMZATT","KIP KM I",135,258,1043,1076,2119
DAKAR,GUEDIAWAYE,"VILLE DE GUEDIAWAYE","WAKHINANE NIMZATT","KIP KM II",130,277,973,955,1928
DAKAR,GUEDIAWAYE,"VILLE DE GUEDIAWAYE","WAKHINANE NIMZATT","KIP KOKO",169,393,1203,1319,2522
DAKAR,GUEDIAWAYE,"VILLE DE GUEDIAWAYE","WAKHINANE NIMZATT","CITE NDIOBENE VIVIANE",143,283,948,990,1938
DAKAR,GUEDIAWAYE,"VILLE DE GUEDIAWAYE","WAKHINANE NIMZATT","NIMZATT I",345,791,2949,2703,5652
DAKAR,GUEDIAWAYE,"VILLE DE GUEDIAWAYE","WAKHINANE NIMZATT","NIMZATT CARREFOUR",76,175,596,513,1109
DAKAR,GUEDIAWAYE,"VILLE DE GUEDIAWAYE","WAKHINANE NIMZATT","TIVAOUANE I",125,250,1066,1055,2121
DAKAR,GUEDIAWAYE,"VILLE DE GUEDIAWAYE","WAKHINANE NIMZATT","TOUBA GUEDIAWAYE",117,235,1003,1048,2051
DAKAR,GUEDIAWAYE,"VILLE DE GUEDIAWAYE","WAKHINANE NIMZATT",WAKHINANE,152,273,1016,1084,2100
DAKAR,GUEDIAWAYE,"VILLE DE GUEDIAWAYE","WAKHINANE NIMZATT","WAKHINANE IV",184,403,1578,1608,3186
DAKAR,GUEDIAWAYE,"VILLE DE GUEDIAWAYE","WAKHINANE NIMZATT","CITE VIVIANE WADE I",216,427,1803,1636,3439
DAKAR,GUEDIAWAYE,"VILLE DE GUEDIAWAYE","WAKHINANE NIMZATT","ANGLE MOUSSE CENTRAL",216,385,1586,1484,3070
DAKAR,GUEDIAWAYE,"VILLE DE GUEDIAWAYE","WAKHINANE NIMZATT","ANGLE MOUSSE KAWSARA",83,208,714,699,1413
DAKAR,GUEDIAWAYE,"VILLE DE GUEDIAWAYE","WAKHINANE NIMZATT","CITE ABDOU DIOUF",205,431,1530,1526,3056
DAKAR,GUEDIAWAYE,"VILLE DE GUEDIAWAYE","WAKHINANE NIMZATT","DAROU RAHMANE I",31,46,215,219,434
DAKAR,GUEDIAWAYE,"VILLE DE GUEDIAWAYE","WAKHINANE NIMZATT","DAROU RAHMANE I BIS",45,64,327,279,606
DAKAR,GUEDIAWAYE,"VILLE DE GUEDIAWAYE","WAKHINANE NIMZATT","GADAYE OCEAN",73,111,367,434,801
DAKAR,GUEDIAWAYE,"VILLE DE GUEDIAWAYE","WAKHINANE NIMZATT","KIP KOKO II",68,117,436,467,903
DAKAR,GUEDIAWAYE,"VILLE DE GUEDIAWAYE","WAKHINANE NIMZATT","MADIENG KHARY DIENG II",25,36,158,155,313
DAKAR,GUEDIAWAYE,"VILLE DE GUEDIAWAYE","WAKHINANE NIMZATT","WAKHINANE CENTRE",126,246,925,902,1827
DAKAR,GUEDIAWAYE,"VILLE DE GUEDIAWAYE","WAKHINANE NIMZATT","WAKHINANE EST",120,238,870,876,1746
DAKAR,GUEDIAWAYE,"VILLE DE GUEDIAWAYE","WAKHINANE NIMZATT","WAKHINANE I",166,343,1194,1218,2412
DAKAR,GUEDIAWAYE,"VILLE DE GUEDIAWAYE","WAKHINANE NIMZATT","WAKHINANE II",152,389,1392,1250,2642
DAKAR,GUEDIAWAYE,"VILLE DE GUEDIAWAYE","WAKHINANE NIMZATT","WAKHINANE IV C",98,197,819,877,1696
DAKAR,GUEDIAWAYE,"VILLE DE GUEDIAWAYE","WAKHINANE NIMZATT","WAKHINANE NIMZATT",17,39,164,138,302