Region,Departement,COM_ARRT_VILLE,COMMUNE,QUARTIER_VILLAGE_HAMEAU,CONCESSION,MENAGE,HOMMES,FEMMES,POPULATION
DAKAR,RUFISQUE,BARGNY,BARGNY,"CITE CASTOR 3 EXTENTION",82,129,668,647,1315
DAKAR,RUFISQUE,BARGNY,BARGNY,"CITE CASTOR EXTENTION",321,417,1370,1336,2706
DAKAR,RUFISQUE,BARGNY,BARGNY,"CITE CASTOR II",123,162,653,658,1311
DAKAR,RUFISQUE,BARGNY,BARGNY,"CITE I",432,518,2276,1816,4092
DAKAR,RUFISQUE,BARGNY,BARGNY,"CITE II",143,241,1001,1024,2025
DAKAR,RUFISQUE,BARGNY,BARGNY,"CITE SERIGNE BABACAR SY",101,122,665,399,1064
DAKAR,RUFISQUE,BARGNY,BARGNY,"DAROU I",142,254,1010,1064,2074
DAKAR,RUFISQUE,BARGNY,BARGNY,"DAROU II",76,109,455,471,926
DAKAR,RUFISQUE,BARGNY,BARGNY,DIAMALAYE,223,277,1235,1261,2496
DAKAR,RUFISQUE,BARGNY,BARGNY,"DIAMALAYE (WAKHANDE)",225,250,981,884,1865
DAKAR,RUFISQUE,BARGNY,BARGNY,"GOUYE DAGA",76,196,902,890,1792
DAKAR,RUFISQUE,BARGNY,BARGNY,"GOUYE DIOULANCAR",81,234,1317,1344,2661
DAKAR,RUFISQUE,BARGNY,BARGNY,"GOUYE NDIANDIA",60,91,383,408,791
DAKAR,RUFISQUE,BARGNY,BARGNY,"KIP CARRIERE",324,547,2044,1955,3999
DAKAR,RUFISQUE,BARGNY,BARGNY,"KIP FINCONE",840,1431,4213,4176,8389
DAKAR,RUFISQUE,BARGNY,BARGNY,LAYENE,75,144,696,658,1354
DAKAR,RUFISQUE,BARGNY,BARGNY,MARNANE,41,78,242,255,497
DAKAR,RUFISQUE,BARGNY,BARGNY,"MBOTH KAW",99,159,747,798,1545
DAKAR,RUFISQUE,BARGNY,BARGNY,"MBOTH WAGUE",146,216,946,878,1824
DAKAR,RUFISQUE,BARGNY,BARGNY,"MEDINATOUL MOUNAWARA",382,510,2043,2085,4128
DAKAR,RUFISQUE,BARGNY,BARGNY,MINAME,56,103,590,465,1055
DAKAR,RUFISQUE,BARGNY,BARGNY,MISSIRAH,146,226,1010,1029,2039
DAKAR,RUFISQUE,BARGNY,BARGNY,NDALDALY,86,168,796,839,1635
DAKAR,RUFISQUE,BARGNY,BARGNY,"NDIAGA SAMB",83,153,1033,933,1966
DAKAR,RUFISQUE,BARGNY,BARGNY,"NDIANDIA I",90,228,1294,1207,2501
DAKAR,RUFISQUE,BARGNY,BARGNY,"NDIANDIA II",14,55,251,266,517
DAKAR,RUFISQUE,BARGNY,BARGNY,"NDIAYENE GUEDJI",15,47,270,292,562
DAKAR,RUFISQUE,BARGNY,BARGNY,NDIOLMANE,85,252,1111,1116,2227
DAKAR,RUFISQUE,BARGNY,BARGNY,"NGOUDA NDIAYENE",55,129,648,666,1314
DAKAR,RUFISQUE,BARGNY,BARGNY,"NGOUDE BAYE",86,193,933,894,1827
DAKAR,RUFISQUE,BARGNY,BARGNY,NGOUNOU,12,21,141,106,247
DAKAR,RUFISQUE,BARGNY,BARGNY,NGUENE,53,129,538,546,1084
DAKAR,RUFISQUE,BARGNY,BARGNY,NIANGUENE,89,198,976,973,1949
DAKAR,RUFISQUE,BARGNY,BARGNY,"SANTHIOUB GUEDJI",113,257,1217,1282,2499
DAKAR,RUFISQUE,BARGNY,BARGNY,"BARGNY VILLE VERTE  I",128,136,534,432,966
DAKAR,RUFISQUE,SENDOU,SENDOU,"SENDOU PEULGHA (PANTHIOUR)",56,61,190,178,368
DAKAR,RUFISQUE,SENDOU,SENDOU,"SENDOU EST EXTENSION",201,243,1410,1247,2657
DAKAR,RUFISQUE,SENDOU,SENDOU,"SENDOU OUEST EXTENSION",15,45,230,239,469
DAKAR,RUFISQUE,SENDOU,SENDOU,"SENDOU THIOSSANE",70,97,294,257,551
DAKAR,RUFISQUE,SANGALKAM,BAMBILOR,BAMBILOR,2771,3193,11858,11486,23344
DAKAR,RUFISQUE,SANGALKAM,BAMBILOR,"DENY BIRAME NDAO NORD",259,359,2284,2008,4292
DAKAR,RUFISQUE,SANGALKAM,BAMBILOR,"DENY BIRAME NDAO SUD",203,286,1514,1406,2920
DAKAR,RUFISQUE,SANGALKAM,BAMBILOR,"DENY GUEDJI SUD",213,245,800,817,1617
DAKAR,RUFISQUE,SANGALKAM,BAMBILOR,"H1 KOURKA PENE",178,183,534,515,1049
DAKAR,RUFISQUE,SANGALKAM,BAMBILOR,"GOROM I",441,534,2510,2385,4895
DAKAR,RUFISQUE,SANGALKAM,BAMBILOR,"GOROM II",639,781,2917,2959,5876
DAKAR,RUFISQUE,SANGALKAM,BAMBILOR,"GOROM III",81,88,397,353,750
DAKAR,RUFISQUE,SANGALKAM,BAMBILOR,"KANIACK NDIAWDOUNE",120,160,736,654,1390
DAKAR,RUFISQUE,SANGALKAM,BAMBILOR,MBEUTHE,174,201,1029,883,1912
DAKAR,RUFISQUE,SANGALKAM,BAMBILOR,"NDIAKHIRATE PEULH",238,293,1043,1006,2049
DAKAR,RUFISQUE,SANGALKAM,BAMBILOR,"NDIOUGOUYE DIACKSAO",179,195,712,614,1326
DAKAR,RUFISQUE,SANGALKAM,BAMBILOR,NGUENDOUF,57,57,211,161,372
DAKAR,RUFISQUE,SANGALKAM,BAMBILOR,WAYABAME,159,189,658,594,1252
DAKAR,RUFISQUE,SANGALKAM,BAMBILOR,"H1 MBEYE",161,190,779,641,1420
DAKAR,RUFISQUE,SANGALKAM,BAMBILOR,"H2 KHOSS KHAR YALLA",48,49,147,76,223
DAKAR,RUFISQUE,SANGALKAM,BAMBILOR,"COMICO V BAMBILOR",1040,1090,3105,3308,6413
DAKAR,RUFISQUE,SANGALKAM,SANGALKAM,"BAKARY DIOP",59,77,390,453,843
DAKAR,RUFISQUE,SANGALKAM,SANGALKAM,BAYAAL,217,244,1048,951,1999
DAKAR,RUFISQUE,SANGALKAM,SANGALKAM,"CITE EL HADJI DOUDOU BASSE II",77,82,242,263,505
DAKAR,RUFISQUE,SANGALKAM,SANGALKAM,"DAROU RAHMANE",334,362,1379,1350,2729
DAKAR,RUFISQUE,SANGALKAM,SANGALKAM,"DAROU SALAM I",159,180,625,709,1334
DAKAR,RUFISQUE,SANGALKAM,SANGALKAM,"DAROU SALAM II",416,449,1760,1610,3370
DAKAR,RUFISQUE,SANGALKAM,SANGALKAM,DIAMAGUENE,72,91,315,307,622
DAKAR,RUFISQUE,SANGALKAM,SANGALKAM,ESCALE,78,106,461,357,818
DAKAR,RUFISQUE,SANGALKAM,SANGALKAM,"NDIAKHIRATE DIGUE",630,863,3570,3117,6687
DAKAR,RUFISQUE,SANGALKAM,SANGALKAM,"NDIAKHIRATE NDIAYENE",464,523,1995,1919,3914
DAKAR,RUFISQUE,SANGALKAM,SANGALKAM,SERERE,33,35,192,194,386
DAKAR,RUFISQUE,SANGALKAM,SANGALKAM,"CITE DABAKH",117,130,406,445,851
DAKAR,RUFISQUE,SANGALKAM,SANGALKAM,"CITE EL HADJ DOUDOU BASSE I",250,266,579,745,1324
DAKAR,RUFISQUE,SANGALKAM,SANGALKAM,"CITE NOUVEL HORIZON",518,562,1594,1745,3339
DAKAR,RUFISQUE,SANGALKAM,SANGALKAM,"CITE SERIGNE BARA",183,202,530,582,1112
DAKAR,RUFISQUE,SANGALKAM,SANGALKAM,"CITE SOCOCIM",105,105,372,359,731
DAKAR,RUFISQUE,SANGALKAM,SANGALKAM,"CITE YACINE IMMO",185,243,676,757,1433
DAKAR,RUFISQUE,SANGALKAM,SANGALKAM,"KEUR DAOUDA SARR",402,480,1785,1942,3727
DAKAR,RUFISQUE,SANGALKAM,SANGALKAM,"KEUR NDIAYE LO",757,982,4285,3976,8261
DAKAR,RUFISQUE,SANGALKAM,SANGALKAM,KOUNOUNE,2288,2557,9300,9641,18941
DAKAR,RUFISQUE,SANGALKAM,SANGALKAM,"KOUNOUNE (CITE KOCHAPEC)",415,446,1432,1447,2879
DAKAR,RUFISQUE,SANGALKAM,SANGALKAM,"KOUNOUNE EXTENSION (CITE AIR FRANCE)",385,421,1169,1199,2368
DAKAR,RUFISQUE,SANGALKAM,SANGALKAM,"KOUNOUNE EXTENSION (SAGEF)",81,94,271,291,562
DAKAR,RUFISQUE,SANGALKAM,SANGALKAM,"KOUNOUNE NGALLAPE",484,527,1872,1879,3751
DAKAR,RUFISQUE,SANGALKAM,SANGALKAM,"LEBOUGUI 2000",438,551,1790,1860,3650
DAKAR,RUFISQUE,SANGALKAM,SANGALKAM,MEDINE,199,231,847,913,1760
DAKAR,RUFISQUE,SANGALKAM,SANGALKAM,"MERE THERESA",74,75,208,209,417
DAKAR,RUFISQUE,SANGALKAM,SANGALKAM,"SYR YAYE DIOR",403,457,1295,1397,2692
DAKAR,RUFISQUE,SANGALKAM,SANGALKAM,"CITE KAWSARE",273,308,1371,1258,2629
DAKAR,RUFISQUE,SANGALKAM,SANGALKAM,"CITE KHALIFA ABABACAR SY EXTENSION",48,51,159,146,305
DAKAR,RUFISQUE,SANGALKAM,SANGALKAM,"CITE MBABA GUISSE",176,187,546,576,1122
DAKAR,RUFISQUE,SANGALKAM,SANGALKAM,"CITE NDIOLA",117,147,506,539,1045
DAKAR,RUFISQUE,SANGALKAM,SANGALKAM,"CITE SOLAIRE",124,131,451,449,900
DAKAR,RUFISQUE,SANGALKAM,SANGALKAM,"DIAMAGUENE CITE VERTE",10,10,30,33,63
DAKAR,RUFISQUE,SANGALKAM,SANGALKAM,"DIANATOU MAHWA",178,190,722,525,1247
DAKAR,RUFISQUE,SANGALKAM,SANGALKAM,"GRANDE MOSQUEE",36,45,190,195,385
DAKAR,RUFISQUE,SANGALKAM,SANGALKAM,"KEUR NDIAYE LO EXTENSION",88,90,308,281,589
DAKAR,RUFISQUE,SANGALKAM,SANGALKAM,"KOUNOUNE ALMADIES II",357,461,1191,1465,2656
DAKAR,RUFISQUE,SANGALKAM,SANGALKAM,"KOUNOUNE EXTENSION (CITE AIR FRANCE KOUNOUNE II)",302,314,993,1086,2079
DAKAR,RUFISQUE,SANGALKAM,SANGALKAM,"KOUNOUNE EXTENSION (SICAP)",160,166,448,429,877
DAKAR,RUFISQUE,SANGALKAM,SANGALKAM,"MEDINA THIOUB",1487,1760,7268,6815,14083
DAKAR,RUFISQUE,SANGALKAM,SANGALKAM,"MEDINATOUL MOUNAWARA",155,183,523,521,1044
DAKAR,RUFISQUE,SANGALKAM,SANGALKAM,"SANGALKAM (DAROU SALAM II)",45,52,230,240,470
DAKAR,RUFISQUE,SANGALKAM,SANGALKAM,TAWFEKH,37,55,216,243,459
DAKAR,RUFISQUE,SANGALKAM,"TIVAOUANE PEULH NIAGHA",BENEUBA,214,238,921,873,1794
DAKAR,RUFISQUE,SANGALKAM,"TIVAOUANE PEULH NIAGHA","H2 KEUR BALLA",657,696,2789,2663,5452
DAKAR,RUFISQUE,SANGALKAM,"TIVAOUANE PEULH NIAGHA","CITE SAFCO III",377,491,1702,1521,3223
DAKAR,RUFISQUE,SANGALKAM,"TIVAOUANE PEULH NIAGHA","DAROU SALAM 2",140,174,466,530,996
DAKAR,RUFISQUE,SANGALKAM,"TIVAOUANE PEULH NIAGHA","DENY GUEDJ NORD",110,127,416,416,832
DAKAR,RUFISQUE,SANGALKAM,"TIVAOUANE PEULH NIAGHA","NIACOUL RAB EXTENSION",50,64,192,179,371
DAKAR,RUFISQUE,SANGALKAM,"TIVAOUANE PEULH NIAGHA","NIAGHA OUOLOF",401,450,1787,1605,3392
DAKAR,RUFISQUE,SANGALKAM,"TIVAOUANE PEULH NIAGHA","NIAGHA PEULH",299,317,1315,1112,2427
DAKAR,RUFISQUE,SANGALKAM,"TIVAOUANE PEULH NIAGHA","TIVAOUANE PEULH",147,196,751,728,1479
DAKAR,RUFISQUE,SANGALKAM,"TIVAOUANE PEULH NIAGHA","CITE APIX",763,975,3459,3742,7201
DAKAR,RUFISQUE,SANGALKAM,"TIVAOUANE PEULH NIAGHA","GROUPE NABY (SOPE NABY)",351,466,1742,1753,3495
DAKAR,RUFISQUE,SANGALKAM,"TIVAOUANE PEULH NIAGHA","KEUR MAREME MBENGUE",344,357,1219,1189,2408
DAKAR,RUFISQUE,SANGALKAM,"TIVAOUANE PEULH NIAGHA",NAMORA,365,383,1571,1525,3096
DAKAR,RUFISQUE,SANGALKAM,"TIVAOUANE PEULH NIAGHA","NIACOUL RAB",2093,2552,9736,9361,19097
DAKAR,RUFISQUE,SANGALKAM,"TIVAOUANE PEULH NIAGHA",SOCABEG,19,22,58,66,124
DAKAR,RUFISQUE,SANGALKAM,"TIVAOUANE PEULH NIAGHA","TAWFEKH SOCABEG",91,92,433,428,861
DAKAR,RUFISQUE,SANGALKAM,"TIVAOUANE PEULH NIAGHA","DAROU SALAM",220,257,1014,1022,2036
DAKAR,RUFISQUE,SANGALKAM,"TIVAOUANE PEULH NIAGHA","ALMADIES 3",285,294,1071,960,2031
DAKAR,RUFISQUE,SANGALKAM,"TIVAOUANE PEULH NIAGHA","ALPHA THIOMBANE",69,70,299,248,547
DAKAR,RUFISQUE,SANGALKAM,"TIVAOUANE PEULH NIAGHA",ARAFAT,66,76,252,258,510
DAKAR,RUFISQUE,SANGALKAM,"TIVAOUANE PEULH NIAGHA",ARAFATE,63,78,339,290,629
DAKAR,RUFISQUE,SANGALKAM,"TIVAOUANE PEULH NIAGHA","CITE AGNES",99,100,308,360,668
DAKAR,RUFISQUE,SANGALKAM,"TIVAOUANE PEULH NIAGHA","CITE COFIA",34,35,94,96,190
DAKAR,RUFISQUE,SANGALKAM,"TIVAOUANE PEULH NIAGHA","CITE DES ENSEIGNANTS",38,41,128,155,283
DAKAR,RUFISQUE,SANGALKAM,"TIVAOUANE PEULH NIAGHA","CITE DES ENSEIGNANTS EXTENTION",151,165,535,617,1152
DAKAR,RUFISQUE,SANGALKAM,"TIVAOUANE PEULH NIAGHA","CITE IPRESS",5,5,14,12,26
DAKAR,RUFISQUE,SANGALKAM,"TIVAOUANE PEULH NIAGHA","CITE ISRA",5,5,15,19,34
DAKAR,RUFISQUE,SANGALKAM,"TIVAOUANE PEULH NIAGHA","CITE NAMORA",277,288,891,926,1817
DAKAR,RUFISQUE,SANGALKAM,"TIVAOUANE PEULH NIAGHA","CITE POLICE",178,180,638,604,1242
DAKAR,RUFISQUE,SANGALKAM,"TIVAOUANE PEULH NIAGHA","CITE SIPRES TIVAOUNE PEULH",104,110,398,440,838
DAKAR,RUFISQUE,SANGALKAM,"TIVAOUANE PEULH NIAGHA","CITE SOCABEG UNITE 2 SANTE YALLA",325,364,1430,1417,2847
DAKAR,RUFISQUE,SANGALKAM,"TIVAOUANE PEULH NIAGHA","CITE TAWFEKH 3",7,7,29,23,52
DAKAR,RUFISQUE,SANGALKAM,"TIVAOUANE PEULH NIAGHA","CITE UCAD 3",92,117,407,359,766
DAKAR,RUFISQUE,SANGALKAM,"TIVAOUANE PEULH NIAGHA","DALAL DIAME",52,59,210,243,453
DAKAR,RUFISQUE,SANGALKAM,"TIVAOUANE PEULH NIAGHA","DARES SALAM",95,119,390,430,820
DAKAR,RUFISQUE,SANGALKAM,"TIVAOUANE PEULH NIAGHA","DAROU KHALIL",70,80,337,326,663
DAKAR,RUFISQUE,SANGALKAM,"TIVAOUANE PEULH NIAGHA","DAROU KHAYRI",145,163,635,596,1231
DAKAR,RUFISQUE,SANGALKAM,"TIVAOUANE PEULH NIAGHA","DAROU KHOUDOUSS",82,94,323,347,670
DAKAR,RUFISQUE,SANGALKAM,"TIVAOUANE PEULH NIAGHA","DAROU RAHMANE 1",148,173,684,642,1326
DAKAR,RUFISQUE,SANGALKAM,"TIVAOUANE PEULH NIAGHA","DAROU RAHMANE 3",225,314,1047,1076,2123
DAKAR,RUFISQUE,SANGALKAM,"TIVAOUANE PEULH NIAGHA","DAROU RAKHEMANE 2",257,282,1082,991,2073
DAKAR,RUFISQUE,SANGALKAM,"TIVAOUANE PEULH NIAGHA","DAROU SALAM 3",107,128,468,475,943
DAKAR,RUFISQUE,SANGALKAM,"TIVAOUANE PEULH NIAGHA","DAROU SALAM BEIGNE BI",112,114,441,385,826
DAKAR,RUFISQUE,SANGALKAM,"TIVAOUANE PEULH NIAGHA","DAROU SALAM NAMORA",92,97,404,326,730
DAKAR,RUFISQUE,SANGALKAM,"TIVAOUANE PEULH NIAGHA","DAROU SALAM TAWFEKHE",46,46,265,262,527
DAKAR,RUFISQUE,SANGALKAM,"TIVAOUANE PEULH NIAGHA",DEGGO,41,81,251,225,476
DAKAR,RUFISQUE,SANGALKAM,"TIVAOUANE PEULH NIAGHA","DIAMAGUENE QUARTIER SIRE CAMARA",100,113,510,451,961
DAKAR,RUFISQUE,SANGALKAM,"TIVAOUANE PEULH NIAGHA","DIAMAGUENE TIVAOUNE PEULH",113,168,584,539,1123
DAKAR,RUFISQUE,SANGALKAM,"TIVAOUANE PEULH NIAGHA",DIAMALAYE,208,241,845,794,1639
DAKAR,RUFISQUE,SANGALKAM,"TIVAOUANE PEULH NIAGHA","DIAME BOUGOUME",159,191,670,623,1293
DAKAR,RUFISQUE,SANGALKAM,"TIVAOUANE PEULH NIAGHA",FALLENE,80,103,361,383,744
DAKAR,RUFISQUE,SANGALKAM,"TIVAOUANE PEULH NIAGHA",FOUTA,64,76,454,422,876
DAKAR,RUFISQUE,SANGALKAM,"TIVAOUANE PEULH NIAGHA",GANDIOL,38,55,305,335,640
DAKAR,RUFISQUE,SANGALKAM,"TIVAOUANE PEULH NIAGHA","HLM 1",148,184,823,734,1557
DAKAR,RUFISQUE,SANGALKAM,"TIVAOUANE PEULH NIAGHA","HLM 2",63,93,360,376,736
DAKAR,RUFISQUE,SANGALKAM,"TIVAOUANE PEULH NIAGHA","HLM 3",91,113,523,505,1028
DAKAR,RUFISQUE,SANGALKAM,"TIVAOUANE PEULH NIAGHA","HLM SAM SAM",82,97,354,326,680
DAKAR,RUFISQUE,SANGALKAM,"TIVAOUANE PEULH NIAGHA","KEUR SALAM",68,72,190,245,435
DAKAR,RUFISQUE,SANGALKAM,"TIVAOUANE PEULH NIAGHA","M’BACKE KADIOR",36,37,132,145,277
DAKAR,RUFISQUE,SANGALKAM,"TIVAOUANE PEULH NIAGHA","MEDINATOUL SALAM NIACOUL RAB",22,25,120,112,232
DAKAR,RUFISQUE,SANGALKAM,"TIVAOUANE PEULH NIAGHA",MISSIRAH,134,148,571,517,1088
DAKAR,RUFISQUE,SANGALKAM,"TIVAOUANE PEULH NIAGHA","MOULAYE DABAKH",119,141,510,504,1014
DAKAR,RUFISQUE,SANGALKAM,"TIVAOUANE PEULH NIAGHA",MOUREL,53,66,251,289,540
DAKAR,RUFISQUE,SANGALKAM,"TIVAOUANE PEULH NIAGHA","MOUREL II",92,111,424,428,852
DAKAR,RUFISQUE,SANGALKAM,"TIVAOUANE PEULH NIAGHA","MOUSDALIFA NGUELMAK",275,304,1091,1066,2157
DAKAR,RUFISQUE,SANGALKAM,"TIVAOUANE PEULH NIAGHA","NAMORA MEDINATOUL MOUNA WA RA",168,183,572,609,1181
DAKAR,RUFISQUE,SANGALKAM,"TIVAOUANE PEULH NIAGHA","NDIAWRIGNE TIVAOUNE PEULH",64,77,355,367,722
DAKAR,RUFISQUE,SANGALKAM,"TIVAOUANE PEULH NIAGHA",NDIAYENE,17,26,114,121,235
DAKAR,RUFISQUE,SANGALKAM,"TIVAOUANE PEULH NIAGHA","NDIBENE TAWFEKHE",201,212,838,810,1648
DAKAR,RUFISQUE,SANGALKAM,"TIVAOUANE PEULH NIAGHA",NDIENENE,68,105,642,637,1279
DAKAR,RUFISQUE,SANGALKAM,"TIVAOUANE PEULH NIAGHA",NDIENGUENE,20,22,116,122,238
DAKAR,RUFISQUE,SANGALKAM,"TIVAOUANE PEULH NIAGHA",NGAYENNE,46,54,299,315,614
DAKAR,RUFISQUE,SANGALKAM,"TIVAOUANE PEULH NIAGHA","NIAGHA FRONTIERE",19,19,78,91,169
DAKAR,RUFISQUE,SANGALKAM,"TIVAOUANE PEULH NIAGHA","NIAGHA NIASSENE",39,43,218,214,432
DAKAR,RUFISQUE,SANGALKAM,"TIVAOUANE PEULH NIAGHA","NIAGHA OULOF CITE LAC ROSE",112,113,223,224,447
DAKAR,RUFISQUE,SANGALKAM,"TIVAOUANE PEULH NIAGHA","NIAGUE DAROU RAHMANE",36,37,136,108,244
DAKAR,RUFISQUE,SANGALKAM,"TIVAOUANE PEULH NIAGHA","NIMZATH ALMADIES",526,576,2050,1995,4045
DAKAR,RUFISQUE,SANGALKAM,"TIVAOUANE PEULH NIAGHA","NIMZATH SALIHINA 1",212,243,717,754,1471
DAKAR,RUFISQUE,SANGALKAM,"TIVAOUANE PEULH NIAGHA",PIKINE,71,98,405,438,843
DAKAR,RUFISQUE,SANGALKAM,"TIVAOUANE PEULH NIAGHA","PIKINE II",77,104,453,435,888
DAKAR,RUFISQUE,SANGALKAM,"TIVAOUANE PEULH NIAGHA","QUARTIER BAYAL BA",67,109,448,447,895
DAKAR,RUFISQUE,SANGALKAM,"TIVAOUANE PEULH NIAGHA","QUARTIER BAYE FALL NIANG",83,87,365,386,751
DAKAR,RUFISQUE,SANGALKAM,"TIVAOUANE PEULH NIAGHA","QUARTIER CHEIKH TIDIANE HANN",124,134,472,411,883
DAKAR,RUFISQUE,SANGALKAM,"TIVAOUANE PEULH NIAGHA","SANTA YALLA KHABANE",176,197,752,725,1477
DAKAR,RUFISQUE,SANGALKAM,"TIVAOUANE PEULH NIAGHA","SERIGNE MANSOUR SY",145,169,600,615,1215
DAKAR,RUFISQUE,SANGALKAM,"TIVAOUANE PEULH NIAGHA","TAWFEKH CFI INVEST",301,320,1065,1165,2230
DAKAR,RUFISQUE,SANGALKAM,"TIVAOUANE PEULH NIAGHA","TAWFEKH TP",129,171,673,596,1269
DAKAR,RUFISQUE,SANGALKAM,"TIVAOUANE PEULH NIAGHA","TAWFEKH YAKAR",133,147,671,677,1348
DAKAR,RUFISQUE,SANGALKAM,"TIVAOUANE PEULH NIAGHA",TAWFEKHE,86,142,545,537,1082
DAKAR,RUFISQUE,SANGALKAM,"TIVAOUANE PEULH NIAGHA","TAWFEKHE CSTP",148,151,599,616,1215
DAKAR,RUFISQUE,SANGALKAM,"TIVAOUANE PEULH NIAGHA","TAWFEKHE LA LINGUERE",363,413,1608,1573,3181
DAKAR,RUFISQUE,SANGALKAM,"TIVAOUANE PEULH NIAGHA","TAWFEKHE YAKAR DM S",84,86,315,373,688
DAKAR,RUFISQUE,SANGALKAM,"TIVAOUANE PEULH NIAGHA","TIVAOUANE PEULH DAROU RAHMANE",190,218,851,785,1636
DAKAR,RUFISQUE,SANGALKAM,"TIVAOUANE PEULH NIAGHA","TIVAOUANE PEULH DIAWRIGNE",79,96,386,388,774
DAKAR,RUFISQUE,SANGALKAM,"TIVAOUANE PEULH NIAGHA","TIVAOUANE PEULH MEDINA",252,285,1205,1071,2276
DAKAR,RUFISQUE,SANGALKAM,"TIVAOUANE PEULH NIAGHA","TIVAOUANE PEULH DADAL KA",125,159,562,593,1155
DAKAR,RUFISQUE,SANGALKAM,"TIVAOUANE PEULH NIAGHA","TIVAOUANE PEULH SAM SAM",138,159,682,657,1339
DAKAR,RUFISQUE,SANGALKAM,"TIVAOUANE PEULH NIAGHA","TIVAOUANE PEULH SANTA YALLAA",219,317,950,971,1921
DAKAR,RUFISQUE,SANGALKAM,"TIVAOUANE PEULH NIAGHA","TIVAOUNE PEULH BAOL",323,380,1487,1510,2997
DAKAR,RUFISQUE,SANGALKAM,"TIVAOUANE PEULH NIAGHA","TIVAOUNE PEULH DIANATOU",212,249,940,1009,1949
DAKAR,RUFISQUE,SANGALKAM,"TIVAOUANE PEULH NIAGHA","TIVAOUNE PEULH KHAR YALLA",70,84,369,313,682
DAKAR,RUFISQUE,SANGALKAM,"TIVAOUANE PEULH NIAGHA","TIVAOUNE PEULH ALPHA THIOMBANE",245,280,1021,1064,2085
DAKAR,RUFISQUE,SANGALKAM,"TIVAOUANE PEULH NIAGHA","TIVAOUNE PEULH DIAWARA",152,159,567,610,1177
DAKAR,RUFISQUE,SANGALKAM,"TIVAOUANE PEULH NIAGHA","TIVAOUNE PEULH SINGANE FALL",57,64,235,240,475
DAKAR,RUFISQUE,SANGALKAM,"TIVAOUANE PEULH NIAGHA","UNITE 5 SOCABEG",2,2,7,8,15
DAKAR,RUFISQUE,SANGALKAM,"TIVAOUANE PEULH NIAGHA","WAKHALDIAME TP",23,30,100,123,223
DAKAR,RUFISQUE,DIAMNIADIO,YENE,KELLE,269,311,1374,1363,2737
DAKAR,RUFISQUE,DIAMNIADIO,YENE,NDITAKH,263,322,1701,1518,3219
DAKAR,RUFISQUE,DIAMNIADIO,YENE,"NDOUKHOURA OUOLOF",98,107,416,279,695
DAKAR,RUFISQUE,DIAMNIADIO,YENE,NIANGHAL,566,774,4496,4316,8812
DAKAR,RUFISQUE,DIAMNIADIO,YENE,"NIAYES KHAYES",51,61,249,198,447
DAKAR,RUFISQUE,DIAMNIADIO,YENE,"TOUBAB DIALAW",519,612,2167,2004,4171
DAKAR,RUFISQUE,DIAMNIADIO,YENE,"YENE GUEDJI",541,723,3847,3630,7477
DAKAR,RUFISQUE,DIAMNIADIO,YENE,"YENE KAW",361,458,2771,2626,5397
DAKAR,RUFISQUE,DIAMNIADIO,YENE,"YENE TODD",156,239,984,953,1937
DAKAR,RUFISQUE,DIAMNIADIO,SEBIKOTANE,"DAROU SALAM",206,320,1328,1487,2815
DAKAR,RUFISQUE,DIAMNIADIO,SEBIKOTANE,"KEURI KAW",98,143,731,730,1461
DAKAR,RUFISQUE,DIAMNIADIO,SEBIKOTANE,"KHOUTANE SERERE",293,395,1470,1524,2994
DAKAR,RUFISQUE,DIAMNIADIO,SEBIKOTANE,NDIOLA,192,236,1122,1158,2280
DAKAR,RUFISQUE,DIAMNIADIO,SEBIKOTANE,NDOYENE,150,190,900,785,1685
DAKAR,RUFISQUE,DIAMNIADIO,SEBIKOTANE,"SEBI ESCALE",101,178,849,845,1694
DAKAR,RUFISQUE,DIAMNIADIO,SEBIKOTANE,"SEBI FASS",342,500,1906,1755,3661
DAKAR,RUFISQUE,DIAMNIADIO,SEBIKOTANE,"SEBI GARAGE",76,112,604,622,1226
DAKAR,RUFISQUE,DIAMNIADIO,SEBIKOTANE,"SEBI GARE",393,486,1943,1770,3713
DAKAR,RUFISQUE,DIAMNIADIO,SEBIKOTANE,"SEBI KIP KIP",302,401,1478,1475,2953
DAKAR,RUFISQUE,DIAMNIADIO,SEBIKOTANE,"SEBI TANGOR",886,1079,4016,3596,7612
DAKAR,RUFISQUE,DIAMNIADIO,SEBIKOTANE,"SEBI THIOKHO",361,642,2224,2203,4427
DAKAR,RUFISQUE,DIAMNIADIO,SEBIKOTANE,YEBA,213,272,1015,1048,2063
DAKAR,RUFISQUE,DIAMNIADIO,SEBIKOTANE,GUENE,125,185,629,621,1250
DAKAR,RUFISQUE,DIAMNIADIO,SEBIKOTANE,SOROKH,124,135,610,596,1206
DAKAR,RUFISQUE,DIAMNIADIO,SEBIKOTANE,"YEBA 2",77,132,646,609,1255
DAKAR,RUFISQUE,DIAMNIADIO,SEBIKOTANE,"YEBA INDA",30,56,291,253,544
DAKAR,RUFISQUE,DIAMNIADIO,DIAMNIADIO,"BOUNKA BAMBARA",55,59,269,250,519
DAKAR,RUFISQUE,DIAMNIADIO,DIAMNIADIO,"DENY BABACAR DIOP",134,153,608,648,1256
DAKAR,RUFISQUE,DIAMNIADIO,DIAMNIADIO,"DENY DEMBA CODOU",170,211,842,632,1474
DAKAR,RUFISQUE,DIAMNIADIO,DIAMNIADIO,"DENY MALICK GUEYE",158,200,914,920,1834
DAKAR,RUFISQUE,DIAMNIADIO,DIAMNIADIO,"DENY NDIAKHIRATE",486,708,2358,1970,4328
DAKAR,RUFISQUE,DIAMNIADIO,DIAMNIADIO,"DENY YOUSSOU",127,153,695,603,1298
DAKAR,RUFISQUE,DIAMNIADIO,DIAMNIADIO,"DOUGAR AITHIA",76,92,357,359,716
DAKAR,RUFISQUE,DIAMNIADIO,DIAMNIADIO,"DOUGAR I (LOSSA GOLA)",179,218,879,912,1791
DAKAR,RUFISQUE,DIAMNIADIO,DIAMNIADIO,"DOUGAR KANOUNE",99,144,561,486,1047
DAKAR,RUFISQUE,DIAMNIADIO,DIAMNIADIO,"DOUGAR OUEST (BOUNKA SERERE)",150,206,702,662,1364
DAKAR,RUFISQUE,DIAMNIADIO,DIAMNIADIO,"DOUGAR PEULH",187,234,1019,877,1896
DAKAR,RUFISQUE,DIAMNIADIO,DIAMNIADIO,"NDOUKHOURA PEULH I",175,202,932,803,1735
DAKAR,RUFISQUE,DIAMNIADIO,DIAMNIADIO,NDOYENE,136,182,912,724,1636
DAKAR,RUFISQUE,DIAMNIADIO,DIAMNIADIO,"DOUGAR POTOU TANGOR",91,125,592,544,1136
DAKAR,RUFISQUE,DIAMNIADIO,DIAMNIADIO,SANTHIE,31,35,154,118,272
DAKAR,RUFISQUE,DIAMNIADIO,DIAMNIADIO,"SEBY PONTY",301,363,2336,1582,3918
DAKAR,RUFISQUE,DIAMNIADIO,DIAMNIADIO,"DOUGAR YAM",34,70,359,365,724
DAKAR,RUFISQUE,DIAMNIADIO,DIAMNIADIO,"CITE DES FONCTIONNAIRES",170,192,418,468,886
DAKAR,RUFISQUE,DIAMNIADIO,DIAMNIADIO,"CITE PORT",253,276,611,627,1238
DAKAR,RUFISQUE,DIAMNIADIO,DIAMNIADIO,"DIAMNIADIO NORD",247,358,1343,1263,2606
DAKAR,RUFISQUE,DIAMNIADIO,DIAMNIADIO,"DIAMNIADIO SUD I",910,1146,4107,3514,7621
DAKAR,RUFISQUE,DIAMNIADIO,DIAMNIADIO,"DIAMNIADIO SUD II",611,919,3626,3245,6871
DAKAR,RUFISQUE,DIAMNIADIO,DIAMNIADIO,BELVEDERE,25,27,153,117,270
DAKAR,RUFISQUE,DIAMNIADIO,DIAMNIADIO,"NDOUKHOURA PEULH II",130,167,769,554,1323
DAKAR,RUFISQUE,"VILLE DE RUFISQUE","RUFISQUE EST","ARAFAT I",136,214,1155,1143,2298
DAKAR,RUFISQUE,"VILLE DE RUFISQUE","RUFISQUE EST","ARAFAT II",408,567,2168,2074,4242
DAKAR,RUFISQUE,"VILLE DE RUFISQUE","RUFISQUE EST","ARAFAT III",260,370,1389,1372,2761
DAKAR,RUFISQUE,"VILLE DE RUFISQUE","RUFISQUE EST","CHAMPS DE COURSE",220,334,1337,1277,2614
DAKAR,RUFISQUE,"VILLE DE RUFISQUE","RUFISQUE EST",CHEIKH,180,282,1229,1215,2444
DAKAR,RUFISQUE,"VILLE DE RUFISQUE","RUFISQUE EST","CITE CASTOR",206,353,1499,1468,2967
DAKAR,RUFISQUE,"VILLE DE RUFISQUE","RUFISQUE EST","COLOBANE I BIS",145,258,1048,1072,2120
DAKAR,RUFISQUE,"VILLE DE RUFISQUE","RUFISQUE EST","COLOBANE I NORD",163,246,1133,1129,2262
DAKAR,RUFISQUE,"VILLE DE RUFISQUE","RUFISQUE EST","COLOBANE II NORD",186,319,1382,1400,2782
DAKAR,RUFISQUE,"VILLE DE RUFISQUE","RUFISQUE EST","COLOBANE II SUD",144,231,851,938,1789
DAKAR,RUFISQUE,"VILLE DE RUFISQUE","RUFISQUE EST","DAROU KARIM",284,455,2006,1758,3764
DAKAR,RUFISQUE,"VILLE DE RUFISQUE","RUFISQUE EST","DAROU NAHIM",510,699,2749,2368,5117
DAKAR,RUFISQUE,"VILLE DE RUFISQUE","RUFISQUE EST",DIATTA,379,558,2649,2546,5195
DAKAR,RUFISQUE,"VILLE DE RUFISQUE","RUFISQUE EST","KEURY KAW",142,204,917,680,1597
DAKAR,RUFISQUE,"VILLE DE RUFISQUE","RUFISQUE EST","KEURY SOUF",160,228,562,605,1167
DAKAR,RUFISQUE,"VILLE DE RUFISQUE","RUFISQUE EST","KEURY SOUF GARE",29,47,148,151,299
DAKAR,RUFISQUE,"VILLE DE RUFISQUE","RUFISQUE EST","MERINA I",82,159,611,627,1238
DAKAR,RUFISQUE,"VILLE DE RUFISQUE","RUFISQUE EST","MERINA II",68,146,520,477,997
DAKAR,RUFISQUE,"VILLE DE RUFISQUE","RUFISQUE EST","THIAWLENE BOUTE",51,151,731,762,1493
DAKAR,RUFISQUE,"VILLE DE RUFISQUE","RUFISQUE EST","THIAWLENE DIGUE",33,113,508,544,1052
DAKAR,RUFISQUE,"VILLE DE RUFISQUE","RUFISQUE EST","THIAWLENE POUYENE",109,283,1240,1232,2472
DAKAR,RUFISQUE,"VILLE DE RUFISQUE","RUFISQUE EST","YOUSSOU MBARGANE DIOP",402,554,1636,1801,3437
DAKAR,RUFISQUE,"VILLE DE RUFISQUE","RUFISQUE EST","ALMADINAH CITY",70,73,212,209,421
DAKAR,RUFISQUE,"VILLE DE RUFISQUE","RUFISQUE EST","ALWAR GOUYE MOURIDE",89,121,621,567,1188
DAKAR,RUFISQUE,"VILLE DE RUFISQUE","RUFISQUE EST","ARAFAT I OUEST",182,288,1255,1210,2465
DAKAR,RUFISQUE,"VILLE DE RUFISQUE","RUFISQUE EST","ARAFAT II EST",78,132,423,433,856
DAKAR,RUFISQUE,"VILLE DE RUFISQUE","RUFISQUE EST","ARAFAT II OUEST",364,622,2298,2513,4811
DAKAR,RUFISQUE,"VILLE DE RUFISQUE","RUFISQUE EST","ARAFAT III KIPP",250,342,1173,1204,2377
DAKAR,RUFISQUE,"VILLE DE RUFISQUE","RUFISQUE EST","ARAFAT IV CAMP MARCHAND",151,210,774,814,1588
DAKAR,RUFISQUE,"VILLE DE RUFISQUE","RUFISQUE EST","ARAFAT IV CASTORS BATA",254,421,1477,1537,3014
DAKAR,RUFISQUE,"VILLE DE RUFISQUE","RUFISQUE EST","CHEIKH SUD",142,191,890,851,1741
DAKAR,RUFISQUE,"VILLE DE RUFISQUE","RUFISQUE EST","CITE SOCOCIM",50,92,419,437,856
DAKAR,RUFISQUE,"VILLE DE RUFISQUE","RUFISQUE EST","COLOBANE GOUYE MOURIDE",151,204,1078,1084,2162
DAKAR,RUFISQUE,"VILLE DE RUFISQUE","RUFISQUE EST","COLOBANE I",146,281,1155,1208,2363
DAKAR,RUFISQUE,"VILLE DE RUFISQUE","RUFISQUE EST","COLOBANE SOCOCIM",68,117,559,590,1149
DAKAR,RUFISQUE,"VILLE DE RUFISQUE","RUFISQUE EST","COLOBANE VOIE FERREE",12,27,106,106,212
DAKAR,RUFISQUE,"VILLE DE RUFISQUE","RUFISQUE EST","KEURY KAW GARE",71,88,382,376,758
DAKAR,RUFISQUE,"VILLE DE RUFISQUE","RUFISQUE EST","LEONA CHAMPS DE COURSE",28,38,146,151,297
DAKAR,RUFISQUE,"VILLE DE RUFISQUE","RUFISQUE EST","TOUBA  ALWAR",363,564,2302,2087,4389
DAKAR,RUFISQUE,"VILLE DE RUFISQUE","RUFISQUE NORD","AYNOUMANE FASS",96,133,609,603,1212
DAKAR,RUFISQUE,"VILLE DE RUFISQUE","RUFISQUE NORD","CITE DABAKH",752,955,3258,3103,6361
DAKAR,RUFISQUE,"VILLE DE RUFISQUE","RUFISQUE NORD","CITE ENSEIGNANTS",199,240,777,862,1639
DAKAR,RUFISQUE,"VILLE DE RUFISQUE","RUFISQUE NORD","CITE SENELEC",147,192,597,649,1246
DAKAR,RUFISQUE,"VILLE DE RUFISQUE","RUFISQUE NORD","CITE TACKO",826,1069,3255,3519,6774
DAKAR,RUFISQUE,"VILLE DE RUFISQUE","RUFISQUE NORD","DANGOU MINAME I",99,151,750,629,1379
DAKAR,RUFISQUE,"VILLE DE RUFISQUE","RUFISQUE NORD","DANGOU MINAME II",71,116,450,409,859
DAKAR,RUFISQUE,"VILLE DE RUFISQUE","RUFISQUE NORD","DANGOU MISSIRAH",117,178,808,791,1599
DAKAR,RUFISQUE,"VILLE DE RUFISQUE","RUFISQUE NORD","DANGOU NORD",402,656,2819,2888,5707
DAKAR,RUFISQUE,"VILLE DE RUFISQUE","RUFISQUE NORD","DANGOU NORD RESIDENCE",161,206,774,777,1551
DAKAR,RUFISQUE,"VILLE DE RUFISQUE","RUFISQUE NORD","DANGOU SUD",82,152,594,577,1171
DAKAR,RUFISQUE,"VILLE DE RUFISQUE","RUFISQUE NORD","DAROU RAKHMANE CENTRE",955,1357,5268,5000,10268
DAKAR,RUFISQUE,"VILLE DE RUFISQUE","RUFISQUE NORD","DAROU RAHMANE II (CITE JARAFF)",523,691,2410,2214,4624
DAKAR,RUFISQUE,"VILLE DE RUFISQUE","RUFISQUE NORD","DAROU RAKHMANE NORD EST",1039,1316,5151,4996,10147
DAKAR,RUFISQUE,"VILLE DE RUFISQUE","RUFISQUE NORD","DAROU RAKHMANE NORD OUEST",927,1298,4906,4374,9280
DAKAR,RUFISQUE,"VILLE DE RUFISQUE","RUFISQUE NORD","DAROU SALAM",164,264,1076,987,2063
DAKAR,RUFISQUE,"VILLE DE RUFISQUE","RUFISQUE NORD",DIAMAGUEUNE,58,105,373,407,780
DAKAR,RUFISQUE,"VILLE DE RUFISQUE","RUFISQUE NORD","DIORGUA CHERIF",555,797,3530,3466,6996
DAKAR,RUFISQUE,"VILLE DE RUFISQUE","RUFISQUE NORD","FASS I",83,174,660,626,1286
DAKAR,RUFISQUE,"VILLE DE RUFISQUE","RUFISQUE NORD","FASS II",345,484,1912,1884,3796
DAKAR,RUFISQUE,"VILLE DE RUFISQUE","RUFISQUE NORD","FASS NOFLAYE I",284,392,1637,1585,3222
DAKAR,RUFISQUE,"VILLE DE RUFISQUE","RUFISQUE NORD","FASS NOFLAYE II (FASS MANKHATANE)",201,337,1406,1292,2698
DAKAR,RUFISQUE,"VILLE DE RUFISQUE","RUFISQUE NORD","GOUYE ALDIANA",487,721,2874,2595,5469
DAKAR,RUFISQUE,"VILLE DE RUFISQUE","RUFISQUE NORD","GUENDEL II",135,252,988,1016,2004
DAKAR,RUFISQUE,"VILLE DE RUFISQUE","RUFISQUE NORD","GUENDEL III",80,147,575,499,1074
DAKAR,RUFISQUE,"VILLE DE RUFISQUE","RUFISQUE NORD","GUENDEL IV",105,222,770,761,1531
DAKAR,RUFISQUE,"VILLE DE RUFISQUE","RUFISQUE NORD","LEONA CHERIF",262,410,1268,1290,2558
DAKAR,RUFISQUE,"VILLE DE RUFISQUE","RUFISQUE NORD","NDAR GOU NDAW",209,346,1556,1351,2907
DAKAR,RUFISQUE,"VILLE DE RUFISQUE","RUFISQUE NORD","NIMZATT I",107,164,639,669,1308
DAKAR,RUFISQUE,"VILLE DE RUFISQUE","RUFISQUE NORD","NIMZATT II",89,138,562,628,1190
DAKAR,RUFISQUE,"VILLE DE RUFISQUE","RUFISQUE NORD","SANTA YALLA RESIDENCE",118,150,584,546,1130
DAKAR,RUFISQUE,"VILLE DE RUFISQUE","RUFISQUE NORD","SANTA YALLA I",324,466,1790,1844,3634
DAKAR,RUFISQUE,"VILLE DE RUFISQUE","RUFISQUE NORD","SANTA YALLA II",1062,1628,5514,5432,10946
DAKAR,RUFISQUE,"VILLE DE RUFISQUE","RUFISQUE NORD","SANTHIABA NDIOBENE",181,407,1433,1381,2814
DAKAR,RUFISQUE,"VILLE DE RUFISQUE","RUFISQUE NORD","SANTHIABA THIARENE",127,212,937,898,1835
DAKAR,RUFISQUE,"VILLE DE RUFISQUE","RUFISQUE NORD","SANTHIABA WAGUE",153,280,1026,841,1867
DAKAR,RUFISQUE,"VILLE DE RUFISQUE","RUFISQUE NORD","THIOKHO RESIDENCE",30,43,139,149,288
DAKAR,RUFISQUE,"VILLE DE RUFISQUE","RUFISQUE NORD","CITE SALAMA (CITE MBAYE JACQUES DIOP)",128,156,496,544,1040
DAKAR,RUFISQUE,"VILLE DE RUFISQUE","RUFISQUE OUEST","CITE ADE",215,292,761,862,1623
DAKAR,RUFISQUE,"VILLE DE RUFISQUE","RUFISQUE OUEST","CITE AGETIP",28,50,124,143,267
DAKAR,RUFISQUE,"VILLE DE RUFISQUE","RUFISQUE OUEST","CITE ASECNA",56,68,225,234,459
DAKAR,RUFISQUE,"VILLE DE RUFISQUE","RUFISQUE OUEST","CITE BATA-ZONE CAP DES BICHES-CITE SENELEC",204,269,832,937,1769
DAKAR,RUFISQUE,"VILLE DE RUFISQUE","RUFISQUE OUEST","CITE CAISSE DE SECURITE SOCIALE",53,61,175,203,378
DAKAR,RUFISQUE,"VILLE DE RUFISQUE","RUFISQUE OUEST","CITE CAPEC",200,225,748,719,1467
DAKAR,RUFISQUE,"VILLE DE RUFISQUE","RUFISQUE OUEST","CITE COLOBANE",49,78,209,233,442
DAKAR,RUFISQUE,"VILLE DE RUFISQUE","RUFISQUE OUEST","CITE CORA FALL",139,233,621,637,1258
DAKAR,RUFISQUE,"VILLE DE RUFISQUE","RUFISQUE OUEST","CITE DIOKOUL GABON",310,488,1764,1879,3643
DAKAR,RUFISQUE,"VILLE DE RUFISQUE","RUFISQUE OUEST","CITE ENSUT",16,39,105,102,207
DAKAR,RUFISQUE,"VILLE DE RUFISQUE","RUFISQUE OUEST","CITE FILAO",115,194,740,756,1496
DAKAR,RUFISQUE,"VILLE DE RUFISQUE","RUFISQUE OUEST","CITE IMPRIMERIE",185,272,803,822,1625
DAKAR,RUFISQUE,"VILLE DE RUFISQUE","RUFISQUE OUEST","CITE IRD (ORSTOM)",158,195,521,635,1156
DAKAR,RUFISQUE,"VILLE DE RUFISQUE","RUFISQUE OUEST","CITE KEUR SERIGNE KOKY-ANDRE KENNY",100,148,370,402,772
DAKAR,RUFISQUE,"VILLE DE RUFISQUE","RUFISQUE OUEST","CITE KHALIFA ABABACAR SY",243,340,846,962,1808
DAKAR,RUFISQUE,"VILLE DE RUFISQUE","RUFISQUE OUEST","CITE MAME SIGA I",74,99,275,267,542
DAKAR,RUFISQUE,"VILLE DE RUFISQUE","RUFISQUE OUEST","CITE MBAO HORIZON",68,91,220,324,544
DAKAR,RUFISQUE,"VILLE DE RUFISQUE","RUFISQUE OUEST","CITE MECS (MUTUELLE DES ENSEIGNANTS CATHOLIQUES DU SENEGAL)",147,196,472,506,978
DAKAR,RUFISQUE,"VILLE DE RUFISQUE","RUFISQUE OUEST","CITE MILLIONNAIRE",306,416,1221,1380,2601
DAKAR,RUFISQUE,"VILLE DE RUFISQUE","RUFISQUE OUEST","CITE MTOA",118,164,563,587,1150
DAKAR,RUFISQUE,"VILLE DE RUFISQUE","RUFISQUE OUEST","CITE PAMECAS",62,87,244,280,524
DAKAR,RUFISQUE,"VILLE DE RUFISQUE","RUFISQUE OUEST","CITE PARAGES",31,43,128,135,263
DAKAR,RUFISQUE,"VILLE DE RUFISQUE","RUFISQUE OUEST","CITE POSTE",113,137,392,492,884
DAKAR,RUFISQUE,"VILLE DE RUFISQUE","RUFISQUE OUEST","CITE RADIO",75,109,370,418,788
DAKAR,RUFISQUE,"VILLE DE RUFISQUE","RUFISQUE OUEST","CITE SAGAM",20,23,112,91,203
DAKAR,RUFISQUE,"VILLE DE RUFISQUE","RUFISQUE OUEST","CITE SAGEF I",80,96,258,284,542
DAKAR,RUFISQUE,"VILLE DE RUFISQUE","RUFISQUE OUEST","CITE SAGEF II",63,69,222,199,421
DAKAR,RUFISQUE,"VILLE DE RUFISQUE","RUFISQUE OUEST","CITE SANTE/ENSEIGNEMENT/FORCES ARMÉES",184,222,437,482,919
DAKAR,RUFISQUE,"VILLE DE RUFISQUE","RUFISQUE OUEST","CITE SAPEURS POMPIERS",195,257,681,921,1602
DAKAR,RUFISQUE,"VILLE DE RUFISQUE","RUFISQUE OUEST","CITE SAR",116,165,454,515,969
DAKAR,RUFISQUE,"VILLE DE RUFISQUE","RUFISQUE OUEST","CITE SENELEC",45,55,159,159,318
DAKAR,RUFISQUE,"VILLE DE RUFISQUE","RUFISQUE OUEST","CITE SERIGNE MANSOUR SY",148,166,503,558,1061
DAKAR,RUFISQUE,"VILLE DE RUFISQUE","RUFISQUE OUEST","CITE SHS",67,93,217,263,480
DAKAR,RUFISQUE,"VILLE DE RUFISQUE","RUFISQUE OUEST","CITE SIPRES",207,220,479,603,1082
DAKAR,RUFISQUE,"VILLE DE RUFISQUE","RUFISQUE OUEST","CITE SOBOA",106,151,418,502,920
DAKAR,RUFISQUE,"VILLE DE RUFISQUE","RUFISQUE OUEST","CITE IRD SOCABEG",84,95,340,295,635
DAKAR,RUFISQUE,"VILLE DE RUFISQUE","RUFISQUE OUEST","CITE SONACOS",216,321,934,1019,1953
DAKAR,RUFISQUE,"VILLE DE RUFISQUE","RUFISQUE OUEST","CITE SONATEL",58,73,264,327,591
DAKAR,RUFISQUE,"VILLE DE RUFISQUE","RUFISQUE OUEST","CITE SONATEL-ZAC MBAO",283,344,847,1024,1871
DAKAR,RUFISQUE,"VILLE DE RUFISQUE","RUFISQUE OUEST","CITE TECHNICIENS DES EAUX (SDE)",223,258,804,931,1735
DAKAR,RUFISQUE,"VILLE DE RUFISQUE","RUFISQUE OUEST","DAROU SALAM AZUR",211,339,1152,1059,2211
DAKAR,RUFISQUE,"VILLE DE RUFISQUE","RUFISQUE OUEST","DIOKOUL KAW",185,357,1487,1432,2919
DAKAR,RUFISQUE,"VILLE DE RUFISQUE","RUFISQUE OUEST","DIOKOUL KHER I",169,359,1300,1434,2734
DAKAR,RUFISQUE,"VILLE DE RUFISQUE","RUFISQUE OUEST","DIOKOUL LANSAR",133,234,1080,955,2035
DAKAR,RUFISQUE,"VILLE DE RUFISQUE","RUFISQUE OUEST","DIOKOUL NDIAYENE",110,209,929,921,1850
DAKAR,RUFISQUE,"VILLE DE RUFISQUE","RUFISQUE OUEST","DIOKOUL NDIOURENE",88,187,769,711,1480
DAKAR,RUFISQUE,"VILLE DE RUFISQUE","RUFISQUE OUEST","DIOKOUL WAGUE",107,223,893,909,1802
DAKAR,RUFISQUE,"VILLE DE RUFISQUE","RUFISQUE OUEST","GUENDEL I",62,100,321,355,676
DAKAR,RUFISQUE,"VILLE DE RUFISQUE","RUFISQUE OUEST","HLM I NDEFANN",158,190,717,788,1505
DAKAR,RUFISQUE,"VILLE DE RUFISQUE","RUFISQUE OUEST","HLM II",68,83,326,305,631
DAKAR,RUFISQUE,"VILLE DE RUFISQUE","RUFISQUE OUEST","HLM III",109,131,495,571,1066
DAKAR,RUFISQUE,"VILLE DE RUFISQUE","RUFISQUE OUEST","LEONA VALDA",108,279,1089,961,2050
DAKAR,RUFISQUE,"VILLE DE RUFISQUE","RUFISQUE OUEST","MEDINA ZAC MBAO",179,262,769,907,1676
DAKAR,RUFISQUE,"VILLE DE RUFISQUE","RUFISQUE OUEST",MEDINE,205,293,1208,1243,2451
DAKAR,RUFISQUE,"VILLE DE RUFISQUE","RUFISQUE OUEST","MOUSDALIFA SOCABEG",67,83,247,279,526
DAKAR,RUFISQUE,"VILLE DE RUFISQUE","RUFISQUE OUEST",NDEUCKOU,161,312,1283,1285,2568
DAKAR,RUFISQUE,"VILLE DE RUFISQUE","RUFISQUE OUEST",NGUESSOU,46,115,360,358,718
DAKAR,RUFISQUE,"VILLE DE RUFISQUE","RUFISQUE OUEST",THIOKHO,123,210,863,859,1722
DAKAR,RUFISQUE,"VILLE DE RUFISQUE","RUFISQUE OUEST","BABOU SALAM",291,384,1089,1276,2365
DAKAR,RUFISQUE,"VILLE DE RUFISQUE","RUFISQUE OUEST","BABOU SALAM 2",302,434,1288,1389,2677
DAKAR,RUFISQUE,"VILLE DE RUFISQUE","RUFISQUE OUEST","BINAL-MBAO HORIZON-SAFETOUR",200,280,736,807,1543
DAKAR,RUFISQUE,"VILLE DE RUFISQUE","RUFISQUE OUEST","CITE MAME SIGA II",19,21,60,54,114
DAKAR,RUFISQUE,"VILLE DE RUFISQUE","RUFISQUE OUEST","DIOKOUL ASMARA TIVAOUANE",133,190,656,675,1331
DAKAR,RUFISQUE,"VILLE DE RUFISQUE","RUFISQUE OUEST","MBEER TAW FEKH COLGATE",410,524,1462,1671,3133
DAKAR,RUFISQUE,"VILLE DE RUFISQUE","RUFISQUE OUEST","MEDINA SALAM ZAC MBAO",72,125,325,398,723