Region,Departement,COM_ARRT_VILLE,COMMUNE,QUARTIER_VILLAGE_HAMEAU,CONCESSION,MENAGE,HOMMES,FEMMES,POPULATION
DAKAR,"KEUR MASSAR",YEUMBEUL,"YEUMBEUL NORD","AFIA III A",299,632,2283,2099,4382
DAKAR,"KEUR MASSAR",YEUMBEUL,"YEUMBEUL NORD","AFIA III B",242,577,1827,1687,3514
DAKAR,"KEUR MASSAR",YEUMBEUL,"YEUMBEUL NORD","AFIA VI",282,605,2015,2049,4064
DAKAR,"KEUR MASSAR",YEUMBEUL,"YEUMBEUL NORD","AINOUMADY III",384,612,2613,2387,5000
DAKAR,"KEUR MASSAR",YEUMBEUL,"YEUMBEUL NORD","AINOUMADY IV",254,530,1775,1684,3459
DAKAR,"KEUR MASSAR",YEUMBEUL,"YEUMBEUL NORD","AINOUMADY I SOTRAC",200,405,1543,1463,3006
DAKAR,"KEUR MASSAR",YEUMBEUL,"YEUMBEUL NORD","ALPOULAR I A",127,220,946,868,1814
DAKAR,"KEUR MASSAR",YEUMBEUL,"YEUMBEUL NORD","ALPOULAR II",2,1,337,351,688
DAKAR,"KEUR MASSAR",YEUMBEUL,"YEUMBEUL NORD","BENE BARAQUE",162,315,1248,1296,2544
DAKAR,"KEUR MASSAR",YEUMBEUL,"YEUMBEUL NORD","BENE BARAQUE III",87,229,504,509,1013
DAKAR,"KEUR MASSAR",YEUMBEUL,"YEUMBEUL NORD","BENE BARAQUE IV",189,301,1280,1178,2458
DAKAR,"KEUR MASSAR",YEUMBEUL,"YEUMBEUL NORD","BENE BARAQUE V",119,210,893,826,1719
DAKAR,"KEUR MASSAR",YEUMBEUL,"YEUMBEUL NORD","BENE BARAQUE VI",249,378,1616,1587,3203
DAKAR,"KEUR MASSAR",YEUMBEUL,"YEUMBEUL NORD","CITE COMICO I",587,847,2682,2524,5206
DAKAR,"KEUR MASSAR",YEUMBEUL,"YEUMBEUL NORD","CITE COMICO II",410,555,1957,1842,3799
DAKAR,"KEUR MASSAR",YEUMBEUL,"YEUMBEUL NORD","CITE COMICO III",573,802,2513,2549,5062
DAKAR,"KEUR MASSAR",YEUMBEUL,"YEUMBEUL NORD","CITE COMICO IV",143,187,687,725,1412
DAKAR,"KEUR MASSAR",YEUMBEUL,"YEUMBEUL NORD","DAROU RAHMANE II",86,187,590,593,1183
DAKAR,"KEUR MASSAR",YEUMBEUL,"YEUMBEUL NORD","DAROU RAHMANE II B",245,482,1545,1464,3009
DAKAR,"KEUR MASSAR",YEUMBEUL,"YEUMBEUL NORD","DAROU RAHMANE III",96,152,677,680,1357
DAKAR,"KEUR MASSAR",YEUMBEUL,"YEUMBEUL NORD","DAROU SALAM",342,627,2421,2304,4725
DAKAR,"KEUR MASSAR",YEUMBEUL,"YEUMBEUL NORD","DAROU SALAM GAROU",164,268,1073,949,2022
DAKAR,"KEUR MASSAR",YEUMBEUL,"YEUMBEUL NORD","DAROU SALAM I",201,366,1468,1463,2931
DAKAR,"KEUR MASSAR",YEUMBEUL,"YEUMBEUL NORD","DAROU SALAM III",123,252,899,869,1768
DAKAR,"KEUR MASSAR",YEUMBEUL,"YEUMBEUL NORD","DAROU SALAM IV",70,110,494,379,873
DAKAR,"KEUR MASSAR",YEUMBEUL,"YEUMBEUL NORD","DAROU SALAM IV B",112,202,814,739,1553
DAKAR,"KEUR MASSAR",YEUMBEUL,"YEUMBEUL NORD","DAROU SALAM IV C",285,521,2045,1987,4032
DAKAR,"KEUR MASSAR",YEUMBEUL,"YEUMBEUL NORD","DAROU SALAM IX",286,556,2022,1998,4020
DAKAR,"KEUR MASSAR",YEUMBEUL,"YEUMBEUL NORD","DAROU SALAM TER",230,396,1481,1444,2925
DAKAR,"KEUR MASSAR",YEUMBEUL,"YEUMBEUL NORD","DAROU SALAM V",140,344,1052,1035,2087
DAKAR,"KEUR MASSAR",YEUMBEUL,"YEUMBEUL NORD","DAROU SALAM V A",133,294,1048,980,2028
DAKAR,"KEUR MASSAR",YEUMBEUL,"YEUMBEUL NORD","DAROU SALAM V A BIS",125,285,986,858,1844
DAKAR,"KEUR MASSAR",YEUMBEUL,"YEUMBEUL NORD","DAROU SALAM V B",121,246,856,875,1731
DAKAR,"KEUR MASSAR",YEUMBEUL,"YEUMBEUL NORD","DAROU SALAM V C",249,462,1801,1691,3492
DAKAR,"KEUR MASSAR",YEUMBEUL,"YEUMBEUL NORD","DAROU SALAM VI D",495,918,3430,3310,6740
DAKAR,"KEUR MASSAR",YEUMBEUL,"YEUMBEUL NORD","DAROU SALAM VI DIAMALAYE",317,552,2118,1994,4112
DAKAR,"KEUR MASSAR",YEUMBEUL,"YEUMBEUL NORD","DAROU SALAM VI E",496,805,3263,3158,6421
DAKAR,"KEUR MASSAR",YEUMBEUL,"YEUMBEUL NORD","DAROU SALAM VIII",522,895,3494,3262,6756
DAKAR,"KEUR MASSAR",YEUMBEUL,"YEUMBEUL NORD",DIAMALAYE,268,432,1578,1607,3185
DAKAR,"KEUR MASSAR",YEUMBEUL,"YEUMBEUL NORD","DJIDAH MARINE",66,100,352,339,691
DAKAR,"KEUR MASSAR",YEUMBEUL,"YEUMBEUL NORD","FASS I",143,297,1160,1121,2281
DAKAR,"KEUR MASSAR",YEUMBEUL,"YEUMBEUL NORD","FASS II",73,122,485,472,957
DAKAR,"KEUR MASSAR",YEUMBEUL,"YEUMBEUL NORD",HOUDALAYE,76,123,572,510,1082
DAKAR,"KEUR MASSAR",YEUMBEUL,"YEUMBEUL NORD",KHAIRA,295,666,2478,2291,4769
DAKAR,"KEUR MASSAR",YEUMBEUL,"YEUMBEUL NORD","LEONA YEUMBEUL",175,464,1456,1338,2794
DAKAR,"KEUR MASSAR",YEUMBEUL,"YEUMBEUL NORD","MEDINA ASECNA I",226,396,1690,1639,3329
DAKAR,"KEUR MASSAR",YEUMBEUL,"YEUMBEUL NORD",NDIOLOFENE,374,637,2623,2315,4938
DAKAR,"KEUR MASSAR",YEUMBEUL,"YEUMBEUL NORD",NEMA,114,213,1016,920,1936
DAKAR,"KEUR MASSAR",YEUMBEUL,"YEUMBEUL NORD","OUEST III B",55,91,405,402,807
DAKAR,"KEUR MASSAR",YEUMBEUL,"YEUMBEUL NORD","YEUMBEUL NDIAYENE",160,317,1166,1246,2412
DAKAR,"KEUR MASSAR",YEUMBEUL,"YEUMBEUL NORD","YEUMBEUL MALIKA SUD",290,469,2182,2110,4292
DAKAR,"KEUR MASSAR",YEUMBEUL,"YEUMBEUL NORD","YEUMBEUL NORD I",73,115,493,458,951
DAKAR,"KEUR MASSAR",YEUMBEUL,"YEUMBEUL NORD","YEUMBEUL NORD II B",93,152,638,586,1224
DAKAR,"KEUR MASSAR",YEUMBEUL,"YEUMBEUL NORD","YEUMBEUL NORD II C",254,440,1920,1720,3640
DAKAR,"KEUR MASSAR",YEUMBEUL,"YEUMBEUL NORD","AINOUMADY V",365,591,2067,1996,4063
DAKAR,"KEUR MASSAR",YEUMBEUL,"YEUMBEUL NORD","AINOUMADY II",304,538,2092,2103,4195
DAKAR,"KEUR MASSAR",YEUMBEUL,"YEUMBEUL NORD","AINOUMADY III 6",259,409,1659,1587,3246
DAKAR,"KEUR MASSAR",YEUMBEUL,"YEUMBEUL NORD","AINOUMADY VII",71,147,465,522,987
DAKAR,"KEUR MASSAR",YEUMBEUL,"YEUMBEUL NORD","AL WAR",21,29,144,147,291
DAKAR,"KEUR MASSAR",YEUMBEUL,"YEUMBEUL NORD","ASECNA B",235,509,1608,1623,3231
DAKAR,"KEUR MASSAR",YEUMBEUL,"YEUMBEUL NORD","ASECNA C",275,632,1932,2009,3941
DAKAR,"KEUR MASSAR",YEUMBEUL,"YEUMBEUL NORD","ASECNA D",153,349,999,1080,2079
DAKAR,"KEUR MASSAR",YEUMBEUL,"YEUMBEUL NORD","ASECNC A",310,645,2232,2291,4523
DAKAR,"KEUR MASSAR",YEUMBEUL,"YEUMBEUL NORD","BENE BARAQUE I B",184,335,1321,1177,2498
DAKAR,"KEUR MASSAR",YEUMBEUL,"YEUMBEUL NORD","BENE BARAQUE II A",127,225,956,830,1786
DAKAR,"KEUR MASSAR",YEUMBEUL,"YEUMBEUL NORD","CITE TAWFEKH",46,61,199,214,413
DAKAR,"KEUR MASSAR",YEUMBEUL,"YEUMBEUL NORD","COMICO IV EXTENSION",176,284,949,995,1944
DAKAR,"KEUR MASSAR",YEUMBEUL,"YEUMBEUL NORD","DAROU SALAM V D",80,151,593,562,1155
DAKAR,"KEUR MASSAR",YEUMBEUL,"YEUMBEUL NORD","DAROU SALAM V EXTENSION",106,180,743,676,1419
DAKAR,"KEUR MASSAR",YEUMBEUL,"YEUMBEUL NORD","GADAYE EXTENSION",150,230,773,871,1644
DAKAR,"KEUR MASSAR",YEUMBEUL,"YEUMBEUL NORD",GANDIOL,97,126,644,637,1281
DAKAR,"KEUR MASSAR",YEUMBEUL,"YEUMBEUL NORD",MEDINE,230,379,1608,1495,3103
DAKAR,"KEUR MASSAR",YEUMBEUL,"YEUMBEUL NORD","OUEST III A",61,100,499,390,889
DAKAR,"KEUR MASSAR",YEUMBEUL,"YEUMBEUL NORD","WAROUWAYE KAO",239,349,1270,1131,2401
DAKAR,"KEUR MASSAR",YEUMBEUL,"YEUMBEUL NORD","YEUMBEUL NORD II A",144,273,1024,1022,2046
DAKAR,"KEUR MASSAR",YEUMBEUL,"YEUMBEUL SUD","ABOU BASS",71,130,390,391,781
DAKAR,"KEUR MASSAR",YEUMBEUL,"YEUMBEUL SUD","AFFIA I",182,373,1373,1285,2658
DAKAR,"KEUR MASSAR",YEUMBEUL,"YEUMBEUL SUD","AFFIA II",251,515,1988,1773,3761
DAKAR,"KEUR MASSAR",YEUMBEUL,"YEUMBEUL SUD","AFFIA II B",188,478,1465,1393,2858
DAKAR,"KEUR MASSAR",YEUMBEUL,"YEUMBEUL SUD","AFFIA IV A",151,311,1142,1037,2179
DAKAR,"KEUR MASSAR",YEUMBEUL,"YEUMBEUL SUD","AFFIA IV B",127,324,1136,965,2101
DAKAR,"KEUR MASSAR",YEUMBEUL,"YEUMBEUL SUD","AFFIA NIMZATT",275,778,2299,2148,4447
DAKAR,"KEUR MASSAR",YEUMBEUL,"YEUMBEUL SUD",AKHLOULAYE,215,415,1723,1478,3201
DAKAR,"KEUR MASSAR",YEUMBEUL,"YEUMBEUL SUD","ALWAR I B",145,295,1175,1133,2308
DAKAR,"KEUR MASSAR",YEUMBEUL,"YEUMBEUL SUD","DAROU SALAM II",246,480,1910,1961,3871
DAKAR,"KEUR MASSAR",YEUMBEUL,"YEUMBEUL SUD",LAYENE,254,442,2007,2054,4061
DAKAR,"KEUR MASSAR",YEUMBEUL,"YEUMBEUL SUD","MBAWORE THIEURIGNE",50,138,505,438,943
DAKAR,"KEUR MASSAR",YEUMBEUL,"YEUMBEUL SUD","MEDINA SALAM",38,112,273,249,522
DAKAR,"KEUR MASSAR",YEUMBEUL,"YEUMBEUL SUD","MEDINA THIAROYE KAO I",256,454,1697,1719,3416
DAKAR,"KEUR MASSAR",YEUMBEUL,"YEUMBEUL SUD","MEDINA THIAROYE KAO II",296,536,2359,2246,4605
DAKAR,"KEUR MASSAR",YEUMBEUL,"YEUMBEUL SUD","MEDINA YEUMBEUL (NDAWENE)",200,361,1556,1661,3217
DAKAR,"KEUR MASSAR",YEUMBEUL,"YEUMBEUL SUD","MEDINA YEUMBEUL II",79,219,645,555,1200
DAKAR,"KEUR MASSAR",YEUMBEUL,"YEUMBEUL SUD","MEDINA YEUMBEUL II A",86,142,648,524,1172
DAKAR,"KEUR MASSAR",YEUMBEUL,"YEUMBEUL SUD","MEDINATOUL MOUNAWARA",366,804,2639,2423,5062
DAKAR,"KEUR MASSAR",YEUMBEUL,"YEUMBEUL SUD","NDIOBENE YEUMBEUL",52,144,647,581,1228
DAKAR,"KEUR MASSAR",YEUMBEUL,"YEUMBEUL SUD",SANTHIABA,110,181,705,746,1451
DAKAR,"KEUR MASSAR",YEUMBEUL,"YEUMBEUL SUD","SEYDOU NOUROU I",137,284,1096,965,2061
DAKAR,"KEUR MASSAR",YEUMBEUL,"YEUMBEUL SUD","SEYDOU NOUROU II",50,99,437,363,800
DAKAR,"KEUR MASSAR",YEUMBEUL,"YEUMBEUL SUD","THIAROYE KAO I (ALIOU DIA)",95,160,824,739,1563
DAKAR,"KEUR MASSAR",YEUMBEUL,"YEUMBEUL SUD","THIAROYE KAO II",159,330,1415,1413,2828
DAKAR,"KEUR MASSAR",YEUMBEUL,"YEUMBEUL SUD","THIAROYE KAO  III",118,195,855,833,1688
DAKAR,"KEUR MASSAR",YEUMBEUL,"YEUMBEUL SUD","THIAROYE KAO III A",108,232,959,899,1858
DAKAR,"KEUR MASSAR",YEUMBEUL,"YEUMBEUL SUD","THIAROYE KAO III D",299,653,2434,2286,4720
DAKAR,"KEUR MASSAR",YEUMBEUL,"YEUMBEUL SUD","THIAROYE KAO V (OUMAR FOUTIYOU)",270,525,2196,2095,4291
DAKAR,"KEUR MASSAR",YEUMBEUL,"YEUMBEUL SUD",THIEURIGNE,38,66,291,290,581
DAKAR,"KEUR MASSAR",YEUMBEUL,"YEUMBEUL SUD","TOUBA YEUMBEUL",238,485,1880,1807,3687
DAKAR,"KEUR MASSAR",YEUMBEUL,"YEUMBEUL SUD","YEUMBEUL NORD",24,58,315,317,632
DAKAR,"KEUR MASSAR",YEUMBEUL,"YEUMBEUL SUD","AFFIA II A",139,246,1070,1025,2095
DAKAR,"KEUR MASSAR",YEUMBEUL,"YEUMBEUL SUD","AFFIA V",105,273,917,885,1802
DAKAR,"KEUR MASSAR",YEUMBEUL,"YEUMBEUL SUD","CAYOR YEUMBEUL",125,232,973,1011,1984
DAKAR,"KEUR MASSAR",YEUMBEUL,"YEUMBEUL SUD","DJIDAH I (AFIA)",127,282,857,896,1753
DAKAR,"KEUR MASSAR",YEUMBEUL,"YEUMBEUL SUD","MEDINA THIAROYE KAO IV",255,512,2031,1884,3915
DAKAR,"KEUR MASSAR",YEUMBEUL,"YEUMBEUL SUD","MEDINA THIAROYE KAO V A",79,189,625,562,1187
DAKAR,"KEUR MASSAR",YEUMBEUL,"YEUMBEUL SUD","MEDINA THIAROYE KAO V B",67,139,568,486,1054
DAKAR,"KEUR MASSAR",YEUMBEUL,"YEUMBEUL SUD","MEDINA THIAROYE KAO III",166,352,1266,1207,2473
DAKAR,"KEUR MASSAR",YEUMBEUL,"YEUMBEUL SUD","THIAROYE KAO  III (ABABACAR SY)",43,58,297,324,621
DAKAR,"KEUR MASSAR",YEUMBEUL,"YEUMBEUL SUD","THIAROYE MINAME I",295,536,2462,2174,4636
DAKAR,"KEUR MASSAR",YEUMBEUL,"YEUMBEUL SUD","THIEURIGNE  II",216,418,1572,1536,3108
DAKAR,"KEUR MASSAR",YEUMBEUL,"YEUMBEUL SUD","TOUBA MINAME II",206,372,1432,1288,2720
DAKAR,"KEUR MASSAR",YEUMBEUL,"YEUMBEUL SUD","TOUBA THIAROYE",67,160,509,461,970
DAKAR,"KEUR MASSAR",MALIKA,"KEUR MASSAR NORD",ALHAMDOULILAHI,141,230,618,718,1336
DAKAR,"KEUR MASSAR",MALIKA,"KEUR MASSAR NORD","ARAFAT I",199,316,1227,1083,2310
DAKAR,"KEUR MASSAR",MALIKA,"KEUR MASSAR NORD","ARAFAT II",343,571,2055,2068,4123
DAKAR,"KEUR MASSAR",MALIKA,"KEUR MASSAR NORD","BOUNE III",151,310,1066,1063,2129
DAKAR,"KEUR MASSAR",MALIKA,"KEUR MASSAR NORD","BOUNE I",460,951,3220,3176,6396
DAKAR,"KEUR MASSAR",MALIKA,"KEUR MASSAR NORD","CASTOR SOTRAC OUEST",293,487,1742,1642,3384
DAKAR,"KEUR MASSAR",MALIKA,"KEUR MASSAR NORD","CITE GENDARMERIE II",227,251,893,806,1699
DAKAR,"KEUR MASSAR",MALIKA,"KEUR MASSAR NORD","CITE NIMRAN-CITE WARDINI",285,356,1268,1190,2458
DAKAR,"KEUR MASSAR",MALIKA,"KEUR MASSAR NORD","DAROU SALAM EXTENSION",462,641,2377,2430,4807
DAKAR,"KEUR MASSAR",MALIKA,"KEUR MASSAR NORD","DAARAY KAMIL",593,920,4177,3816,7993
DAKAR,"KEUR MASSAR",MALIKA,"KEUR MASSAR NORD","DAROU MISSETTE (KANEL)",71,144,380,362,742
DAKAR,"KEUR MASSAR",MALIKA,"KEUR MASSAR NORD","DAROU MISSETTE CENTRE I",129,240,890,823,1713
DAKAR,"KEUR MASSAR",MALIKA,"KEUR MASSAR NORD","DAROU MISSETTE CENTRE II",64,111,440,387,827
DAKAR,"KEUR MASSAR",MALIKA,"KEUR MASSAR NORD","DAROU MISSETTE EST I",140,270,860,851,1711
DAKAR,"KEUR MASSAR",MALIKA,"KEUR MASSAR NORD","DAROU MISSETTE EST II",133,229,810,680,1490
DAKAR,"KEUR MASSAR",MALIKA,"KEUR MASSAR NORD","DAROU MISSETTE EST III",177,314,1186,1141,2327
DAKAR,"KEUR MASSAR",MALIKA,"KEUR MASSAR NORD","DAROU MISSETTE NORD",171,251,1071,937,2008
DAKAR,"KEUR MASSAR",MALIKA,"KEUR MASSAR NORD","DAROU MISSETTE OUEST ALWAR",161,264,1039,1041,2080
DAKAR,"KEUR MASSAR",MALIKA,"KEUR MASSAR NORD","DAROU MISSETTE SUD",136,207,812,744,1556
DAKAR,"KEUR MASSAR",MALIKA,"KEUR MASSAR NORD","DAROU RAHMANE II",154,219,945,875,1820
DAKAR,"KEUR MASSAR",MALIKA,"KEUR MASSAR NORD","DAROU SALAM",45,69,278,318,596
DAKAR,"KEUR MASSAR",MALIKA,"KEUR MASSAR NORD","DAROU SALAM I BIS",347,565,2246,2219,4465
DAKAR,"KEUR MASSAR",MALIKA,"KEUR MASSAR NORD","DAROU SALAM II (BOUNE)",114,209,2337,1401,3738
DAKAR,"KEUR MASSAR",MALIKA,"KEUR MASSAR NORD","DIACKSAO I",211,352,1203,1266,2469
DAKAR,"KEUR MASSAR",MALIKA,"KEUR MASSAR NORD","DIACKSAO II (DEKH GOUMACK)",226,354,1314,1299,2613
DAKAR,"KEUR MASSAR",MALIKA,"KEUR MASSAR NORD",DINGUIRAYE,193,271,985,1009,1994
DAKAR,"KEUR MASSAR",MALIKA,"KEUR MASSAR NORD",FASS,316,489,1907,1986,3893
DAKAR,"KEUR MASSAR",MALIKA,"KEUR MASSAR NORD",HAMDALAYE,333,528,2326,2085,4411
DAKAR,"KEUR MASSAR",MALIKA,"KEUR MASSAR NORD",HOUSNA,126,213,808,840,1648
DAKAR,"KEUR MASSAR",MALIKA,"KEUR MASSAR NORD",JARDIN,110,166,651,678,1329
DAKAR,"KEUR MASSAR",MALIKA,"KEUR MASSAR NORD",KAWSARA,124,168,662,509,1171
DAKAR,"KEUR MASSAR",MALIKA,"KEUR MASSAR NORD","KEUR MASSAR CENTRE",76,129,522,573,1095
DAKAR,"KEUR MASSAR",MALIKA,"KEUR MASSAR NORD","KHAR YALLA",209,302,1140,1033,2173
DAKAR,"KEUR MASSAR",MALIKA,"KEUR MASSAR NORD","KHEUREUP KEUR",22,26,106,99,205
DAKAR,"KEUR MASSAR",MALIKA,"KEUR MASSAR NORD","MEDINA (GANA SARR)",328,488,1596,1691,3287
DAKAR,"KEUR MASSAR",MALIKA,"KEUR MASSAR NORD","MEDINATOUL MOUNAWARA",642,1307,4590,4453,9043
DAKAR,"KEUR MASSAR",MALIKA,"KEUR MASSAR NORD","MEDINATOUL RASSOUL",213,386,1481,1397,2878
DAKAR,"KEUR MASSAR",MALIKA,"KEUR MASSAR NORD","MEDINATOUL SALAM",342,497,2293,2021,4314
DAKAR,"KEUR MASSAR",MALIKA,"KEUR MASSAR NORD","MEDINATOUL SALAM I",231,350,1393,1361,2754
DAKAR,"KEUR MASSAR",MALIKA,"KEUR MASSAR NORD","MEDINATOUL SALAM II",170,235,1161,1121,2282
DAKAR,"KEUR MASSAR",MALIKA,"KEUR MASSAR NORD","MINAME KEUR MASSAR",93,149,652,530,1182
DAKAR,"KEUR MASSAR",MALIKA,"KEUR MASSAR NORD",MONTAGNE,74,136,496,459,955
DAKAR,"KEUR MASSAR",MALIKA,"KEUR MASSAR NORD","MONTAGNE I (DARADJI)",150,255,1024,954,1978
DAKAR,"KEUR MASSAR",MALIKA,"KEUR MASSAR NORD","MONTAGNE II",127,144,605,527,1132
DAKAR,"KEUR MASSAR",MALIKA,"KEUR MASSAR NORD",NDIAYENE,29,66,297,313,610
DAKAR,"KEUR MASSAR",MALIKA,"KEUR MASSAR NORD","NIAYES NDIORANE",437,677,2220,2101,4321
DAKAR,"KEUR MASSAR",MALIKA,"KEUR MASSAR NORD","NIMZAT SANT YALLA",248,325,994,998,1992
DAKAR,"KEUR MASSAR",MALIKA,"KEUR MASSAR NORD","OUMAR DIALLO",112,200,574,671,1245
DAKAR,"KEUR MASSAR",MALIKA,"KEUR MASSAR NORD","PARCELLES ASSAINIES UNITE 1",94,208,528,678,1206
DAKAR,"KEUR MASSAR",MALIKA,"KEUR MASSAR NORD","PARCELLES ASSAINIES UNITE 9",296,480,1514,1615,3129
DAKAR,"KEUR MASSAR",MALIKA,"KEUR MASSAR NORD","PARCELLES ASSAINIES UNITE 10",246,378,1193,1215,2408
DAKAR,"KEUR MASSAR",MALIKA,"KEUR MASSAR NORD","PARCELLES ASSAINIES UNITE 11",492,922,3107,3038,6145
DAKAR,"KEUR MASSAR",MALIKA,"KEUR MASSAR NORD","PARCELLES ASSAINIES UNITE 12",312,639,1990,1945,3935
DAKAR,"KEUR MASSAR",MALIKA,"KEUR MASSAR NORD","PARCELLES ASSAINIES UNITE 13",258,523,1549,1728,3277
DAKAR,"KEUR MASSAR",MALIKA,"KEUR MASSAR NORD","PARCELLES ASSAINIES UNITE 14",329,600,1938,1941,3879
DAKAR,"KEUR MASSAR",MALIKA,"KEUR MASSAR NORD","PARCELLES ASSAINIES UNITE 15",394,778,2551,2376,4927
DAKAR,"KEUR MASSAR",MALIKA,"KEUR MASSAR NORD","PARCELLES ASSAINIES UNITE 16",326,578,1826,1822,3648
DAKAR,"KEUR MASSAR",MALIKA,"KEUR MASSAR NORD","PARCELLES ASSAINIES UNITE 17",115,267,859,886,1745
DAKAR,"KEUR MASSAR",MALIKA,"KEUR MASSAR NORD",PEULGHA,76,132,523,531,1054
DAKAR,"KEUR MASSAR",MALIKA,"KEUR MASSAR NORD","SAM SAM I (ZONE RECASEMENT I)",261,413,1554,1630,3184
DAKAR,"KEUR MASSAR",MALIKA,"KEUR MASSAR NORD","SAM SAM III (ZONE RECASEMENT III)",217,323,1364,1321,2685
DAKAR,"KEUR MASSAR",MALIKA,"KEUR MASSAR NORD","SANT YALLA BOUNE",394,607,2580,2493,5073
DAKAR,"KEUR MASSAR",MALIKA,"KEUR MASSAR NORD","SANT YALLA I",184,286,1081,984,2065
DAKAR,"KEUR MASSAR",MALIKA,"KEUR MASSAR NORD",SANTHIABA,77,158,599,567,1166
DAKAR,"KEUR MASSAR",MALIKA,"KEUR MASSAR NORD","TAIBA KEUR MASSAR",151,233,794,898,1692
DAKAR,"KEUR MASSAR",MALIKA,"KEUR MASSAR NORD",TAWFEX,220,365,1694,1580,3274
DAKAR,"KEUR MASSAR",MALIKA,"KEUR MASSAR NORD","ZONE RECASEMENT II (SAM SAM II)",235,363,1204,1384,2588
DAKAR,"KEUR MASSAR",MALIKA,"KEUR MASSAR NORD","CITE HOPITAL TRADITIONNEL",196,254,755,865,1620
DAKAR,"KEUR MASSAR",MALIKA,"KEUR MASSAR NORD","CITE MARINE KEUR MASSAR",50,53,186,168,354
DAKAR,"KEUR MASSAR",MALIKA,"KEUR MASSAR NORD","DAROU SALAM II ZONE MBEUBEUSS",229,320,1225,1067,2292
DAKAR,"KEUR MASSAR",MALIKA,"KEUR MASSAR NORD",FIRDAWSI,259,356,1099,1172,2271
DAKAR,"KEUR MASSAR",MALIKA,"KEUR MASSAR NORD","PARCELLES ASSAINIES UNITE 2",207,438,1374,1277,2651
DAKAR,"KEUR MASSAR",MALIKA,"KEUR MASSAR NORD","PARCELLES ASSAINIES UNITE 3",149,317,937,923,1860
DAKAR,"KEUR MASSAR",MALIKA,"KEUR MASSAR NORD","PARCELLES ASSAINIES UNITE 4",361,757,1968,2050,4018
DAKAR,"KEUR MASSAR",MALIKA,"KEUR MASSAR NORD","PARCELLES ASSAINIES UNITE 5",480,880,2687,2813,5500
DAKAR,"KEUR MASSAR",MALIKA,"KEUR MASSAR NORD","PARCELLES ASSAINIES UNITE 6",351,683,1957,1935,3892
DAKAR,"KEUR MASSAR",MALIKA,"KEUR MASSAR NORD","PARCELLES ASSAINIES UNITE 18",89,205,636,643,1279
DAKAR,"KEUR MASSAR",MALIKA,"KEUR MASSAR NORD","TAWFEKH TYR",134,149,615,555,1170
DAKAR,"KEUR MASSAR",MALIKA,"KEUR MASSAR NORD","ALMADIE KEUR MASSAR",125,153,497,536,1033
DAKAR,"KEUR MASSAR",MALIKA,"KEUR MASSAR NORD","CITE ENDA",35,37,101,131,232
DAKAR,"KEUR MASSAR",MALIKA,"KEUR MASSAR NORD","CITE UNIE",128,153,298,347,645
DAKAR,"KEUR MASSAR",MALIKA,"KEUR MASSAR NORD","DAROU HABIBI",88,107,306,364,670
DAKAR,"KEUR MASSAR",MALIKA,"KEUR MASSAR NORD","DAROU SALAM II",265,458,1025,961,1986
DAKAR,"KEUR MASSAR",MALIKA,"KEUR MASSAR NORD","FIRDAWSI EXTENSION",84,94,302,306,608
DAKAR,"KEUR MASSAR",MALIKA,"KEUR MASSAR NORD",HAFIA,105,122,476,384,860
DAKAR,"KEUR MASSAR",MALIKA,"KEUR MASSAR NORD","KEUR MASSAR/SOUFOU MONTAGNE",190,366,1183,1147,2330
DAKAR,"KEUR MASSAR",MALIKA,"KEUR MASSAR NORD","MEDINA FASS",146,182,557,531,1088
DAKAR,"KEUR MASSAR",MALIKA,"KEUR MASSAR NORD","NGUEDIAGA 2 MALIKA  MONTAGNE",219,360,1400,1308,2708
DAKAR,"KEUR MASSAR",MALIKA,"KEUR MASSAR NORD","NGUEDIAGA I",167,213,959,1023,1982
DAKAR,"KEUR MASSAR",MALIKA,"KEUR MASSAR NORD","NGUEDIEGA  A I MONTAGNE",150,202,820,857,1677
DAKAR,"KEUR MASSAR",MALIKA,"KEUR MASSAR NORD","SERIGNE MANSOUR SY",123,128,440,485,925
DAKAR,"KEUR MASSAR",MALIKA,"KEUR MASSAR NORD","TAÎBA 2 KEUR MASSAR",125,186,750,602,1352
DAKAR,"KEUR MASSAR",MALIKA,MALIKA,"CITE SONATEL",355,853,2052,2058,4110
DAKAR,"KEUR MASSAR",MALIKA,MALIKA,"DIAMAGUENE I",256,414,1403,1455,2858
DAKAR,"KEUR MASSAR",MALIKA,MALIKA,"DIAMAGUENE II",125,216,955,750,1705
DAKAR,"KEUR MASSAR",MALIKA,MALIKA,"DIAMAGUENE III",113,184,788,746,1534
DAKAR,"KEUR MASSAR",MALIKA,MALIKA,"DIAMALAYE MALIKA",954,1592,5222,4737,9959
DAKAR,"KEUR MASSAR",MALIKA,MALIKA,KAWSARA,266,451,1630,1632,3262
DAKAR,"KEUR MASSAR",MALIKA,MALIKA,"MALIKA NORD",117,171,707,716,1423
DAKAR,"KEUR MASSAR",MALIKA,MALIKA,"MALIKA SUR MER",451,783,2408,2678,5086
DAKAR,"KEUR MASSAR",MALIKA,MALIKA,"MEDINA PEULH I",86,170,727,835,1562
DAKAR,"KEUR MASSAR",MALIKA,MALIKA,"MEDINA PEULH II",106,190,684,704,1388
DAKAR,"KEUR MASSAR",MALIKA,MALIKA,ANSAR,84,129,660,669,1329
DAKAR,"KEUR MASSAR",MALIKA,MALIKA,"DAROU SALAM MALIKA",216,360,1226,1316,2542
DAKAR,"KEUR MASSAR",MALIKA,MALIKA,"GRAND MALIKA",130,253,1042,1039,2081
DAKAR,"KEUR MASSAR",MALIKA,MALIKA,"MALIKA EXTENSION NORD",354,598,1870,1982,3852
DAKAR,"KEUR MASSAR",MALIKA,MALIKA,"MAME LAMINE GADIAGA",148,230,885,936,1821
DAKAR,"KEUR MASSAR",MALIKA,MALIKA,"MEDINATOUL MOUNAWARA",132,195,609,671,1280
DAKAR,"KEUR MASSAR",MALIKA,MALIKA,"MEDINATOUL SALAM",329,805,1671,1845,3516
DAKAR,"KEUR MASSAR",MALIKA,MALIKA,"SAM 1",56,87,500,400,900
DAKAR,"KEUR MASSAR",MALIKA,MALIKA,"SAM 2",102,182,839,909,1748
DAKAR,"KEUR MASSAR",MALIKA,MALIKA,"SANTHIABA NDIAGO",71,140,493,477,970
DAKAR,"KEUR MASSAR",MALIKA,MALIKA,"TODD BA",334,469,1934,1847,3781
DAKAR,"KEUR MASSAR",JAXAAY,"JAXAAY PARCELLES","CITE GENDARMERIE",910,1401,3623,3695,7318
DAKAR,"KEUR MASSAR",JAXAAY,"JAXAAY PARCELLES","PARCELLES ASSAINIES UNITE 9",310,443,1195,1305,2500
DAKAR,"KEUR MASSAR",JAXAAY,"JAXAAY PARCELLES","PARCELLES ASSAINIES UNITE 10",303,456,1286,1446,2732
DAKAR,"KEUR MASSAR",JAXAAY,"JAXAAY PARCELLES","JAXAAY PARCELLES UNITE 11 A",202,252,1091,1030,2121
DAKAR,"KEUR MASSAR",JAXAAY,"JAXAAY PARCELLES","PARCELLES ASSAINIES UNITE 11 B",296,422,1687,1639,3326
DAKAR,"KEUR MASSAR",JAXAAY,"JAXAAY PARCELLES","PARCELLES ASSAINIES UNITE 12 A",85,131,448,495,943
DAKAR,"KEUR MASSAR",JAXAAY,"JAXAAY PARCELLES","JAXAAY PARCELLES UNITE 12 B",355,436,2025,2021,4046
DAKAR,"KEUR MASSAR",JAXAAY,"JAXAAY PARCELLES","PARCELLES ASSAINIES UNITE 13",256,436,1304,1292,2596
DAKAR,"KEUR MASSAR",JAXAAY,"JAXAAY PARCELLES","PARCELLES ASSAINIES UNITE 14",271,539,1314,1344,2658
DAKAR,"KEUR MASSAR",JAXAAY,"JAXAAY PARCELLES","PARCELLES ASSAINIES UNITE 19",628,728,2875,2770,5645
DAKAR,"KEUR MASSAR",JAXAAY,"JAXAAY PARCELLES","PARCELLES ASSAINIES UNITE 15",250,371,1079,1120,2199
DAKAR,"KEUR MASSAR",JAXAAY,"JAXAAY PARCELLES","PARCELLES ASSAINIES UNITE 16",233,342,1116,1052,2168
DAKAR,"KEUR MASSAR",JAXAAY,"JAXAAY PARCELLES","PARCELLES ASSAINIES UNITE 17 A",562,732,3134,3107,6241
DAKAR,"KEUR MASSAR",JAXAAY,"JAXAAY PARCELLES","PARCELLES ASSAINIES UNITE 17 B",154,212,778,824,1602
DAKAR,"KEUR MASSAR",JAXAAY,"JAXAAY PARCELLES","PARCELLES ASSAINIES UNITE 18",162,216,698,685,1383
DAKAR,"KEUR MASSAR",JAXAAY,"JAXAAY PARCELLES","PARCELLES ASSAINIES UNITE 20",341,421,1715,1646,3361
DAKAR,"KEUR MASSAR",JAXAAY,"JAXAAY PARCELLES","PARCELLES ASSAINIES UNITE 21",617,833,2966,3076,6042
DAKAR,"KEUR MASSAR",JAXAAY,"JAXAAY PARCELLES","PARCELLES ASSAINIES UNITE 22",231,313,981,999,1980
DAKAR,"KEUR MASSAR",JAXAAY,"JAXAAY PARCELLES","PARCELLES ASSAINIES UNITE 23",259,378,1254,1189,2443
DAKAR,"KEUR MASSAR",JAXAAY,"JAXAAY PARCELLES","PARCELLES ASSAINIES UNITE 24",196,557,900,986,1886
DAKAR,"KEUR MASSAR",JAXAAY,"JAXAAY PARCELLES","PARCELLES ASSAINIES UNITE 25",61,104,321,354,675
DAKAR,"KEUR MASSAR",JAXAAY,"JAXAAY PARCELLES","PARCELLES ASSAINIES UNITE 27",129,199,651,676,1327
DAKAR,"KEUR MASSAR",JAXAAY,"JAXAAY PARCELLES","CITE TERANGA",278,454,1085,1250,2335
DAKAR,"KEUR MASSAR",JAXAAY,"JAXAAY PARCELLES","CITE DUBAI",209,439,1028,972,2000
DAKAR,"KEUR MASSAR",JAXAAY,"JAXAAY PARCELLES","PARCELLES ASSAINIES UNITE 11 A",146,252,732,777,1509
DAKAR,"KEUR MASSAR",JAXAAY,"KEUR MASSAR SUD","ABDOU AZIZ SY DABAKH",327,532,1858,1862,3720
DAKAR,"KEUR MASSAR",JAXAAY,"KEUR MASSAR SUD","AINOUMADY I",115,125,317,261,578
DAKAR,"KEUR MASSAR",JAXAAY,"KEUR MASSAR SUD","AINOUMADY II",252,433,1253,1354,2607
DAKAR,"KEUR MASSAR",JAXAAY,"KEUR MASSAR SUD","AINOUMADY II CITE POLICE",91,139,384,449,833
DAKAR,"KEUR MASSAR",JAXAAY,"KEUR MASSAR SUD","AINOUMADY II CITE SENELEC",116,202,584,538,1122
DAKAR,"KEUR MASSAR",JAXAAY,"KEUR MASSAR SUD","AINOUMADY II CITE SONACOS",181,323,869,874,1743
DAKAR,"KEUR MASSAR",JAXAAY,"KEUR MASSAR SUD","AINOUMADY III",316,600,1723,1702,3425
DAKAR,"KEUR MASSAR",JAXAAY,"KEUR MASSAR SUD","BAYE GANA AW",127,197,652,638,1290
DAKAR,"KEUR MASSAR",JAXAAY,"KEUR MASSAR SUD","BAYE NIASS",170,257,824,794,1618
DAKAR,"KEUR MASSAR",JAXAAY,"KEUR MASSAR SUD","CASTOR SOTRAC EST",179,280,914,974,1888
DAKAR,"KEUR MASSAR",JAXAAY,"KEUR MASSAR SUD","CITE CAMILLE BASSE",282,386,1041,1164,2205
DAKAR,"KEUR MASSAR",JAXAAY,"KEUR MASSAR SUD","CITE MAME DIOR",220,318,874,933,1807
DAKAR,"KEUR MASSAR",JAXAAY,"KEUR MASSAR SUD","CITE MUNICIPALE",374,773,2154,2156,4310
DAKAR,"KEUR MASSAR",JAXAAY,"KEUR MASSAR SUD","CONACHAP CITE PENITENCIERE",244,418,909,887,1796
DAKAR,"KEUR MASSAR",JAXAAY,"KEUR MASSAR SUD","DAROU RAHMANE I",156,253,1045,928,1973
DAKAR,"KEUR MASSAR",JAXAAY,"KEUR MASSAR SUD","DAROU SALAM I",256,412,1265,1361,2626
DAKAR,"KEUR MASSAR",JAXAAY,"KEUR MASSAR SUD","DAROU SALAM II",187,275,1141,998,2139
DAKAR,"KEUR MASSAR",JAXAAY,"KEUR MASSAR SUD",DIAMALAYE,167,245,899,941,1840
DAKAR,"KEUR MASSAR",JAXAAY,"KEUR MASSAR SUD",DIAMWELLI,159,215,798,852,1650
DAKAR,"KEUR MASSAR",JAXAAY,"KEUR MASSAR SUD","DIOKOUL KEUR EL HADJI",290,528,1698,1637,3335
DAKAR,"KEUR MASSAR",JAXAAY,"KEUR MASSAR SUD","GRAND MEDINE",96,147,608,677,1285
DAKAR,"KEUR MASSAR",JAXAAY,"KEUR MASSAR SUD","HAMDALLAHI III",122,154,611,589,1200
DAKAR,"KEUR MASSAR",JAXAAY,"KEUR MASSAR SUD","KANGUE II CITE LA LINGUERE",246,350,966,1032,1998
DAKAR,"KEUR MASSAR",JAXAAY,"KEUR MASSAR SUD","KEUR BAKA",380,693,1832,1906,3738
DAKAR,"KEUR MASSAR",JAXAAY,"KEUR MASSAR SUD","KEUR EL HADJI PATHE",283,372,1458,1394,2852
DAKAR,"KEUR MASSAR",JAXAAY,"KEUR MASSAR SUD","MADIABEL DIOP",111,188,656,636,1292
DAKAR,"KEUR MASSAR",JAXAAY,"KEUR MASSAR SUD","MAMADOU FAYE",185,275,1014,896,1910
DAKAR,"KEUR MASSAR",JAXAAY,"KEUR MASSAR SUD","MEDINA KELLE",234,474,1647,1557,3204
DAKAR,"KEUR MASSAR",JAXAAY,"KEUR MASSAR SUD","MEDINA KEUR MASSAR",109,154,591,554,1145
DAKAR,"KEUR MASSAR",JAXAAY,"KEUR MASSAR SUD","MINAM GABANE",106,139,623,610,1233
DAKAR,"KEUR MASSAR",JAXAAY,"KEUR MASSAR SUD",MISSIRAH,179,261,929,936,1865
DAKAR,"KEUR MASSAR",JAXAAY,"KEUR MASSAR SUD","PARCELLES ASSAINIES UNITE 2",192,351,1004,963,1967
DAKAR,"KEUR MASSAR",JAXAAY,"KEUR MASSAR SUD","PARCELLES ASSAINIES UNITE 3",245,773,1278,1401,2679
DAKAR,"KEUR MASSAR",JAXAAY,"KEUR MASSAR SUD","PARCELLES ASSAINIES UNITE 4",382,739,1784,1803,3587
DAKAR,"KEUR MASSAR",JAXAAY,"KEUR MASSAR SUD","PARCELLES ASSAINIES UNITE 5",258,405,1219,1278,2497
DAKAR,"KEUR MASSAR",JAXAAY,"KEUR MASSAR SUD","PARCELLES ASSAINIES UNITE 6",135,232,680,703,1383
DAKAR,"KEUR MASSAR",JAXAAY,"KEUR MASSAR SUD","SANT YALLA II",289,530,1772,1689,3461
DAKAR,"KEUR MASSAR",JAXAAY,"KEUR MASSAR SUD","TOUBA NIANI",154,209,761,735,1496
DAKAR,"KEUR MASSAR",JAXAAY,"KEUR MASSAR SUD","UCAD I ET UCAD II",186,238,760,875,1635
DAKAR,"KEUR MASSAR",JAXAAY,"KEUR MASSAR SUD","UCAD IV",666,968,3081,3000,6081
DAKAR,"KEUR MASSAR",JAXAAY,"KEUR MASSAR SUD","AINOUMADY EXTENSION",49,77,216,268,484
DAKAR,"KEUR MASSAR",JAXAAY,"KEUR MASSAR SUD","AINOUMADY V",131,201,608,663,1271
DAKAR,"KEUR MASSAR",JAXAAY,"KEUR MASSAR SUD","CITE AL AZHAR",142,240,752,676,1428
DAKAR,"KEUR MASSAR",JAXAAY,"KEUR MASSAR SUD","DAROU SALAM SOTRAC",135,397,675,683,1358
DAKAR,"KEUR MASSAR",JAXAAY,"KEUR MASSAR SUD","MEDINA KELLE II",147,250,817,866,1683
DAKAR,"KEUR MASSAR",JAXAAY,"KEUR MASSAR SUD","PARCELLES ASSAINIES UNITE 1",125,236,703,711,1414
DAKAR,"KEUR MASSAR",JAXAAY,"KEUR MASSAR SUD","PARCELLES ASSAINIES UNITE 26",57,83,271,291,562
DAKAR,"KEUR MASSAR",JAXAAY,"KEUR MASSAR SUD","TAWFEKH 2",135,202,676,700,1376
DAKAR,"KEUR MASSAR",JAXAAY,"KEUR MASSAR SUD","YA SALAM CASTOR SOTRAC",230,421,1329,1436,2765
DAKAR,"KEUR MASSAR",JAXAAY,"KEUR MASSAR SUD","AINOUMADY IV",142,193,591,675,1266
DAKAR,"KEUR MASSAR",JAXAAY,"KEUR MASSAR SUD","GANDEL CISSE",117,276,916,703,1619
DAKAR,"KEUR MASSAR",JAXAAY,"KEUR MASSAR SUD","MEDINA SALAM",93,235,547,576,1123