Region,Departement,COM_ARRT_VILLE,COMMUNE,QUARTIER_VILLAGE_HAMEAU,CONCESSION,MENAGE,HOMMES,FEMMES,POPULATION
DAKAR,PIKINE,"VILLE DE PIKINE","PIKINE OUEST","CITE ICOTAF (ZONE INDUSTRIELLE)",107,251,762,783,1545
DAKAR,PIKINE,"VILLE DE PIKINE","PIKINE OUEST","CITE LOBATT FALL",90,116,332,356,688
DAKAR,PIKINE,"VILLE DE PIKINE","PIKINE OUEST","CITE SOTIBA",108,264,843,840,1683
DAKAR,PIKINE,"VILLE DE PIKINE","PIKINE OUEST","COLOBANE NIANGHOR",128,271,954,921,1875
DAKAR,PIKINE,"VILLE DE PIKINE","PIKINE OUEST","CREDIT FONCIER",245,534,1711,1761,3472
DAKAR,PIKINE,"VILLE DE PIKINE","PIKINE OUEST","DAROU NIANGHOR",203,525,1593,1461,3054
DAKAR,PIKINE,"VILLE DE PIKINE","PIKINE OUEST","DAROU SALAM I",61,159,505,508,1013
DAKAR,PIKINE,"VILLE DE PIKINE","PIKINE OUEST","CITE TECHNOPOLE",390,850,2442,2413,4855
DAKAR,PIKINE,"VILLE DE PIKINE","PIKINE OUEST","DAROU SALAM III",169,477,1488,1285,2773
DAKAR,PIKINE,"VILLE DE PIKINE","PIKINE OUEST","DIAMAGUENE II",70,185,604,532,1136
DAKAR,PIKINE,"VILLE DE PIKINE","PIKINE OUEST","GAZELLE EST",175,513,1426,1543,2969
DAKAR,PIKINE,"VILLE DE PIKINE","PIKINE OUEST","GAZELLE OUEST",231,676,2133,2108,4241
DAKAR,PIKINE,"VILLE DE PIKINE","PIKINE OUEST","ICOTAF I",209,459,1417,1314,2731
DAKAR,PIKINE,"VILLE DE PIKINE","PIKINE OUEST","ICOTAF II",244,485,1695,1736,3431
DAKAR,PIKINE,"VILLE DE PIKINE","PIKINE OUEST","MAKA COLOBANE DIAMAGUENE",103,317,1032,922,1954
DAKAR,PIKINE,"VILLE DE PIKINE","PIKINE OUEST","MAKA COLOBANE II",80,198,573,568,1141
DAKAR,PIKINE,"VILLE DE PIKINE","PIKINE OUEST","MISSIRAH COLOBANE",185,484,1535,1366,2901
DAKAR,PIKINE,"VILLE DE PIKINE","PIKINE OUEST","MISSIRAH WAKHALDIAM",194,493,1536,1510,3046
DAKAR,PIKINE,"VILLE DE PIKINE","PIKINE OUEST","SOTIBA EXTENSION",195,362,1256,1362,2618
DAKAR,PIKINE,"VILLE DE PIKINE","PIKINE OUEST","DAROU SALAM II",196,606,1840,1771,3611
DAKAR,PIKINE,"VILLE DE PIKINE","PIKINE OUEST","LOTISSEMENT ABATTOIR",106,238,918,894,1812
DAKAR,PIKINE,"VILLE DE PIKINE","PIKINE OUEST","MAKA COLOBANE ABBATOIR",119,338,1146,1155,2301
DAKAR,PIKINE,"VILLE DE PIKINE","PIKINE OUEST","MAKA COLOBANE I",160,409,1283,1107,2390
DAKAR,PIKINE,"VILLE DE PIKINE","PIKINE EST","ALLEES COURSINS I",90,191,642,583,1225
DAKAR,PIKINE,"VILLE DE PIKINE","PIKINE EST","ALLEES COURSINS II",71,135,486,450,936
DAKAR,PIKINE,"VILLE DE PIKINE","PIKINE EST","CHAMPS DE COURSE I",241,591,1895,1770,3665
DAKAR,PIKINE,"VILLE DE PIKINE","PIKINE EST","CHAMPS DE COURSE II",168,419,1319,1026,2345
DAKAR,PIKINE,"VILLE DE PIKINE","PIKINE EST","CITE COCOTIERS",183,386,1224,1323,2547
DAKAR,PIKINE,"VILLE DE PIKINE","PIKINE EST","CITE PEPINIERE",183,393,1171,1039,2210
DAKAR,PIKINE,"VILLE DE PIKINE","PIKINE EST","ZONE ARTISANALE",45,154,438,314,752
DAKAR,PIKINE,"VILLE DE PIKINE","PIKINE EST","CITE SERIGNE MANSOUR SY",260,565,1791,1722,3513
DAKAR,PIKINE,"VILLE DE PIKINE","PIKINE EST","CITE STAGD I",86,184,623,575,1198
DAKAR,PIKINE,"VILLE DE PIKINE","PIKINE EST","FASS MARIGOT I",115,294,859,849,1708
DAKAR,PIKINE,"VILLE DE PIKINE","PIKINE EST","NIMZATT II",188,442,1295,1311,2606
DAKAR,PIKINE,"VILLE DE PIKINE","PIKINE EST","TOUBA DIACKSAO",209,497,1494,1398,2892
DAKAR,PIKINE,"VILLE DE PIKINE","PIKINE EST","WAKHINANE I",84,246,584,528,1112
DAKAR,PIKINE,"VILLE DE PIKINE","PIKINE EST","WAKHINANE II",131,330,1007,945,1952
DAKAR,PIKINE,"VILLE DE PIKINE","PIKINE EST","WAKHINANE III A",48,98,368,338,706
DAKAR,PIKINE,"VILLE DE PIKINE","PIKINE EST","WAKHINANE III B",159,315,1063,984,2047
DAKAR,PIKINE,"VILLE DE PIKINE","PIKINE EST","WAKHINANE III C",24,45,189,139,328
DAKAR,PIKINE,"VILLE DE PIKINE","PIKINE EST","CITE STAGD II",80,149,484,491,975
DAKAR,PIKINE,"VILLE DE PIKINE","PIKINE NORD","AINOUMANE I",131,377,1187,1160,2347
DAKAR,PIKINE,"VILLE DE PIKINE","PIKINE NORD","AINOUMANE II",91,287,926,838,1764
DAKAR,PIKINE,"VILLE DE PIKINE","PIKINE NORD","COLOBANE ARAFAT",174,390,1203,1139,2342
DAKAR,PIKINE,"VILLE DE PIKINE","PIKINE NORD","COLOBANE LANSAR",161,342,1132,1104,2236
DAKAR,PIKINE,"VILLE DE PIKINE","PIKINE NORD","COLOBANE ROBINET TILL",225,464,1555,1582,3137
DAKAR,PIKINE,"VILLE DE PIKINE","PIKINE NORD","DAROU KHOUDOSS",502,1208,3716,3696,7412
DAKAR,PIKINE,"VILLE DE PIKINE","PIKINE NORD","DIACKSAO FASS I",149,349,1069,1110,2179
DAKAR,PIKINE,"VILLE DE PIKINE","PIKINE NORD","DIACKSAO FASS II",133,350,1020,873,1893
DAKAR,PIKINE,"VILLE DE PIKINE","PIKINE NORD","FASS MARIGOT II",171,466,1387,1222,2609
DAKAR,PIKINE,"VILLE DE PIKINE","PIKINE NORD","GUEULE TAPEE",76,145,540,472,1012
DAKAR,PIKINE,"VILLE DE PIKINE","PIKINE NORD","MEDINA PIKINE",215,513,1652,1643,3295
DAKAR,PIKINE,"VILLE DE PIKINE","PIKINE NORD",NDIASSANE,225,517,1450,1321,2771
DAKAR,PIKINE,"VILLE DE PIKINE","PIKINE NORD","NIMZATT I",250,725,2271,2107,4378
DAKAR,PIKINE,"VILLE DE PIKINE","PIKINE NORD","NIMZATT II",177,475,1525,1547,3072
DAKAR,PIKINE,"VILLE DE PIKINE","PIKINE NORD","ROUTE DES NIAYES",118,279,787,840,1627
DAKAR,PIKINE,"VILLE DE PIKINE","PIKINE NORD","SAM COLOBANE",237,516,1660,1773,3433
DAKAR,PIKINE,"VILLE DE PIKINE","PIKINE NORD",SEUKEUBE,102,226,734,712,1446
DAKAR,PIKINE,"VILLE DE PIKINE","PIKINE NORD","WAKHINANE NORD",143,359,1224,911,2135
DAKAR,PIKINE,"VILLE DE PIKINE",DALIFORT,"CITE ASSURANCE",155,260,736,715,1451
DAKAR,PIKINE,"VILLE DE PIKINE",DALIFORT,"CITE  BELVEDERE",258,543,1567,1580,3147
DAKAR,PIKINE,"VILLE DE PIKINE",DALIFORT,"CITE CASTORS FORCES ARMÉES",155,363,1229,1138,2367
DAKAR,PIKINE,"VILLE DE PIKINE",DALIFORT,"CITE HILAL 2 HACIENDA",80,168,402,468,870
DAKAR,PIKINE,"VILLE DE PIKINE",DALIFORT,"CITE MARINE III",206,359,1083,1095,2178
DAKAR,PIKINE,"VILLE DE PIKINE",DALIFORT,"CITE MOR MATY SARR",300,886,2299,2262,4561
DAKAR,PIKINE,"VILLE DE PIKINE",DALIFORT,"CITE MUNICIPALITE (MAIRIE)",155,439,1273,1223,2496
DAKAR,PIKINE,"VILLE DE PIKINE",DALIFORT,"CITE SOLEIL",87,150,384,376,760
DAKAR,PIKINE,"VILLE DE PIKINE",DALIFORT,"DAROU SALAM",131,429,1066,921,1987
DAKAR,PIKINE,"VILLE DE PIKINE",DALIFORT,DEGGO,101,304,847,723,1570
DAKAR,PIKINE,"VILLE DE PIKINE",DALIFORT,"TOUBA SERAS",345,916,2261,2050,4311
DAKAR,PIKINE,"VILLE DE PIKINE",DALIFORT,"CITE MOMAR NDIAYE",33,61,269,232,501
DAKAR,PIKINE,"VILLE DE PIKINE",DALIFORT,"CITE SHELL",65,152,351,369,720
DAKAR,PIKINE,"VILLE DE PIKINE",DALIFORT,"DALIFORT I",102,319,820,803,1623
DAKAR,PIKINE,"VILLE DE PIKINE",DALIFORT,"DALIFORT I RUE 10",81,210,751,645,1396
DAKAR,PIKINE,"VILLE DE PIKINE",DALIFORT,"DALIFORT II",93,247,838,761,1599
DAKAR,PIKINE,"VILLE DE PIKINE",DALIFORT,"DALIFORT IV GENERALE FONCIERE",134,375,1149,1094,2243
DAKAR,PIKINE,"VILLE DE PIKINE",DALIFORT,"DALIFORT S/Q 1 MARCHÉ",97,257,830,739,1569
DAKAR,PIKINE,"VILLE DE PIKINE",DALIFORT,"DALIFORT S/Q 10",104,387,1032,960,1992
DAKAR,PIKINE,"VILLE DE PIKINE",DALIFORT,"DALIFORT S/Q 4",53,108,331,398,729
DAKAR,PIKINE,"VILLE DE PIKINE",DALIFORT,"DALIFORT S/Q 5 TALLY CARREAUX",60,145,533,493,1026
DAKAR,PIKINE,"VILLE DE PIKINE","DJIDAH THIAROYE KAO","AINOUMANE I",52,102,455,406,861
DAKAR,PIKINE,"VILLE DE PIKINE","DJIDAH THIAROYE KAO","AINOUMANE II",123,240,840,787,1627
DAKAR,PIKINE,"VILLE DE PIKINE","DJIDAH THIAROYE KAO","AINOUMANE III",337,785,3006,2756,5762
DAKAR,PIKINE,"VILLE DE PIKINE","DJIDAH THIAROYE KAO","BAGDAD ALWARE",45,56,339,335,674
DAKAR,PIKINE,"VILLE DE PIKINE","DJIDAH THIAROYE KAO","BAGDAD I",71,131,683,597,1280
DAKAR,PIKINE,"VILLE DE PIKINE","DJIDAH THIAROYE KAO","BAGDAD II",51,140,389,408,797
DAKAR,PIKINE,"VILLE DE PIKINE","DJIDAH THIAROYE KAO","BAGDAD III",56,92,420,382,802
DAKAR,PIKINE,"VILLE DE PIKINE","DJIDAH THIAROYE KAO","BAGDAD IV",40,57,303,280,583
DAKAR,PIKINE,"VILLE DE PIKINE","DJIDAH THIAROYE KAO",DAROULAYE,245,504,1954,1600,3554
DAKAR,PIKINE,"VILLE DE PIKINE","DJIDAH THIAROYE KAO","DAROU RAHMANE II",95,205,727,665,1392
DAKAR,PIKINE,"VILLE DE PIKINE","DJIDAH THIAROYE KAO","GOUYE SALAM I",152,232,1129,1063,2192
DAKAR,PIKINE,"VILLE DE PIKINE","DJIDAH THIAROYE KAO","GOUYE SALAM II B",145,354,1138,1095,2233
DAKAR,PIKINE,"VILLE DE PIKINE","DJIDAH THIAROYE KAO","GOUYE SALAM I B",150,312,1260,1130,2390
DAKAR,PIKINE,"VILLE DE PIKINE","DJIDAH THIAROYE KAO","HAMDALAYE II A",119,205,960,901,1861
DAKAR,PIKINE,"VILLE DE PIKINE","DJIDAH THIAROYE KAO","HAMDALAYE II B",182,367,1764,1474,3238
DAKAR,PIKINE,"VILLE DE PIKINE","DJIDAH THIAROYE KAO","HAMDALAYE II C",77,158,711,578,1289
DAKAR,PIKINE,"VILLE DE PIKINE","DJIDAH THIAROYE KAO","MINAM II B",101,206,776,710,1486
DAKAR,PIKINE,"VILLE DE PIKINE","DJIDAH THIAROYE KAO",LANSAR,348,715,2417,2504,4921
DAKAR,PIKINE,"VILLE DE PIKINE","DJIDAH THIAROYE KAO","LEONA I",131,243,1173,1090,2263
DAKAR,PIKINE,"VILLE DE PIKINE","DJIDAH THIAROYE KAO","LEONA II A ET II B",175,326,1425,1192,2617
DAKAR,PIKINE,"VILLE DE PIKINE","DJIDAH THIAROYE KAO","MEDINA IV",135,252,1020,924,1944
DAKAR,PIKINE,"VILLE DE PIKINE","DJIDAH THIAROYE KAO","MEDINATOUL MOUNAWARA",254,657,1990,1970,3960
DAKAR,PIKINE,"VILLE DE PIKINE","DJIDAH THIAROYE KAO",MESSERE,267,607,2009,1703,3712
DAKAR,PIKINE,"VILLE DE PIKINE","DJIDAH THIAROYE KAO","MOUSDALIFA I",141,393,1196,950,2146
DAKAR,PIKINE,"VILLE DE PIKINE","DJIDAH THIAROYE KAO","MOUSDALIFA II",94,226,722,614,1336
DAKAR,PIKINE,"VILLE DE PIKINE","DJIDAH THIAROYE KAO","MOUSDALIFA III",116,243,818,710,1528
DAKAR,PIKINE,"VILLE DE PIKINE","DJIDAH THIAROYE KAO","MOUSDALIFA IV",106,204,783,759,1542
DAKAR,PIKINE,"VILLE DE PIKINE","DJIDAH THIAROYE KAO","GRAND PIKINE (NIETTY MBAR)",34,54,198,186,384
DAKAR,PIKINE,"VILLE DE PIKINE","DJIDAH THIAROYE KAO","SAM SAM II  (CITE POLICE)",69,219,518,431,949
DAKAR,PIKINE,"VILLE DE PIKINE","DJIDAH THIAROYE KAO","SANTE YALLA",317,588,2463,2243,4706
DAKAR,PIKINE,"VILLE DE PIKINE","DJIDAH THIAROYE KAO",SEFFA,260,530,1858,1805,3663
DAKAR,PIKINE,"VILLE DE PIKINE","DJIDAH THIAROYE KAO","SEFFA EXTENSION",47,125,311,347,658
DAKAR,PIKINE,"VILLE DE PIKINE","DJIDAH THIAROYE KAO","SINAYE BABACAR SY",131,236,902,919,1821
DAKAR,PIKINE,"VILLE DE PIKINE","DJIDAH THIAROYE KAO","THIAROYE MINAME I",144,308,1187,1134,2321
DAKAR,PIKINE,"VILLE DE PIKINE","DJIDAH THIAROYE KAO","TOUBA PIKINE",290,638,2185,2065,4250
DAKAR,PIKINE,"VILLE DE PIKINE","DJIDAH THIAROYE KAO","TOUBA THIAROYE",137,294,997,963,1960
DAKAR,PIKINE,"VILLE DE PIKINE","DJIDAH THIAROYE KAO","AINOUMANE I A",95,157,770,740,1510
DAKAR,PIKINE,"VILLE DE PIKINE","DJIDAH THIAROYE KAO","AINOUMANE SANT YALLA II",97,202,660,664,1324
DAKAR,PIKINE,"VILLE DE PIKINE","DJIDAH THIAROYE KAO","AINOUMANE SANT YALLA III",59,95,471,474,945
DAKAR,PIKINE,"VILLE DE PIKINE","DJIDAH THIAROYE KAO","BAGDAD DIOFFIOR",122,167,887,855,1742
DAKAR,PIKINE,"VILLE DE PIKINE","DJIDAH THIAROYE KAO","BAGDAD II A",88,132,673,661,1334
DAKAR,PIKINE,"VILLE DE PIKINE","DJIDAH THIAROYE KAO","DJIDAH I ET II",231,501,1769,1569,3338
DAKAR,PIKINE,"VILLE DE PIKINE","DJIDAH THIAROYE KAO","FASS III",84,235,674,566,1240
DAKAR,PIKINE,"VILLE DE PIKINE","DJIDAH THIAROYE KAO","FASS IV",61,130,441,402,843
DAKAR,PIKINE,"VILLE DE PIKINE","DJIDAH THIAROYE KAO","HALWAR II",108,198,817,824,1641
DAKAR,PIKINE,"VILLE DE PIKINE","DJIDAH THIAROYE KAO","HALWAR III",78,133,599,551,1150
DAKAR,PIKINE,"VILLE DE PIKINE","DJIDAH THIAROYE KAO","LEONA III",81,188,670,546,1216
DAKAR,PIKINE,"VILLE DE PIKINE","DJIDAH THIAROYE KAO","MEDINA GOUNASS EXTENSION",44,84,314,312,626
DAKAR,PIKINE,"VILLE DE PIKINE","DJIDAH THIAROYE KAO","MINAM II A",141,288,1259,1153,2412
DAKAR,PIKINE,"VILLE DE PIKINE","DJIDAH THIAROYE KAO","TOUBA BAGDAD II",129,233,1074,1031,2105
DAKAR,PIKINE,"VILLE DE PIKINE","GUINAW RAIL NORD","DAROU RAHMATY",184,394,1462,1312,2774
DAKAR,PIKINE,"VILLE DE PIKINE","GUINAW RAIL NORD","DAROU SALAM I",79,180,619,602,1221
DAKAR,PIKINE,"VILLE DE PIKINE","GUINAW RAIL NORD","DAROU SALAM II",190,386,1283,1261,2544
DAKAR,PIKINE,"VILLE DE PIKINE","GUINAW RAIL NORD","DAROU SALAM II B",172,312,1319,1195,2514
DAKAR,PIKINE,"VILLE DE PIKINE","GUINAW RAIL NORD","GRAND THIAROYE I",202,422,1542,1391,2933
DAKAR,PIKINE,"VILLE DE PIKINE","GUINAW RAIL NORD","GRAND THIAROYE II BIS",317,642,2205,2158,4363
DAKAR,PIKINE,"VILLE DE PIKINE","GUINAW RAIL NORD","GRAND THIAROYE V",172,417,1327,1271,2598
DAKAR,PIKINE,"VILLE DE PIKINE","GUINAW RAIL NORD","MEDINATOUL MOUNAWARA I",144,321,969,861,1830
DAKAR,PIKINE,"VILLE DE PIKINE","GUINAW RAIL NORD","MEDINATOUL MOUNAWARA II",183,400,1352,1208,2560
DAKAR,PIKINE,"VILLE DE PIKINE","GUINAW RAIL NORD","SAM II BIS",153,346,1129,1060,2189
DAKAR,PIKINE,"VILLE DE PIKINE","GUINAW RAIL NORD",SANGOMAR,120,220,836,780,1616
DAKAR,PIKINE,"VILLE DE PIKINE","GUINAW RAIL NORD","GRAND THIAROYE II",223,442,1568,1593,3161
DAKAR,PIKINE,"VILLE DE PIKINE","GUINAW RAIL SUD","AINOUMANE IV A",188,448,1458,1285,2743
DAKAR,PIKINE,"VILLE DE PIKINE","GUINAW RAIL SUD","CITE EL HADJI MALICK SY",86,172,668,708,1376
DAKAR,PIKINE,"VILLE DE PIKINE","GUINAW RAIL SUD","DAROU KHOUDOSS",122,292,886,900,1786
DAKAR,PIKINE,"VILLE DE PIKINE","GUINAW RAIL SUD","DAROU MARNANE I",122,221,921,794,1715
DAKAR,PIKINE,"VILLE DE PIKINE","GUINAW RAIL SUD","DAROU MARNANE II",62,143,500,491,991
DAKAR,PIKINE,"VILLE DE PIKINE","GUINAW RAIL SUD","DAROU MARNANE III",79,138,622,622,1244
DAKAR,PIKINE,"VILLE DE PIKINE","GUINAW RAIL SUD","DAROU MARNANE IV",97,213,754,704,1458
DAKAR,PIKINE,"VILLE DE PIKINE","GUINAW RAIL SUD","DAROU MARNANE SANT YALLA I",102,162,795,780,1575
DAKAR,PIKINE,"VILLE DE PIKINE","GUINAW RAIL SUD","DAROU MARNANE SANT YALLA II",101,244,868,794,1662
DAKAR,PIKINE,"VILLE DE PIKINE","GUINAW RAIL SUD","DAROU MARNANE V",100,287,882,839,1721
DAKAR,PIKINE,"VILLE DE PIKINE","GUINAW RAIL SUD","DAROU NAHIM",206,613,1916,1632,3548
DAKAR,PIKINE,"VILLE DE PIKINE","GUINAW RAIL SUD","GRAND THIAROYE III",119,212,933,952,1885
DAKAR,PIKINE,"VILLE DE PIKINE","GUINAW RAIL SUD","GRAND THIAROYE IV",38,87,311,351,662
DAKAR,PIKINE,"VILLE DE PIKINE","GUINAW RAIL SUD","GRAND THIAROYE VII",106,230,856,787,1643
DAKAR,PIKINE,"VILLE DE PIKINE","GUINAW RAIL SUD","MOUSDALIFA I",191,478,1569,1444,3013
DAKAR,PIKINE,"VILLE DE PIKINE","GUINAW RAIL SUD","MOUSDALIFA II",86,229,759,634,1393
DAKAR,PIKINE,"VILLE DE PIKINE","GUINAW RAIL SUD","MOUSDALIFA III",49,160,504,478,982
DAKAR,PIKINE,"VILLE DE PIKINE","GUINAW RAIL SUD","MOUSDALIFA IV",65,137,497,448,945
DAKAR,PIKINE,"VILLE DE PIKINE","GUINAW RAIL SUD","SAM II",75,184,579,524,1103
DAKAR,PIKINE,"VILLE DE PIKINE","GUINAW RAIL SUD","TIVAOUANE II",51,102,376,376,752
DAKAR,PIKINE,"VILLE DE PIKINE","GUINAW RAIL SUD","YALLA YANA",126,277,1065,1001,2066
DAKAR,PIKINE,"VILLE DE PIKINE","GUINAW RAIL SUD","AÏNOUMANE VI B",160,380,1282,1116,2398
DAKAR,PIKINE,"VILLE DE PIKINE","GUINAW RAIL SUD","DAROU SALAM SOTRAC",57,111,416,429,845
DAKAR,PIKINE,"VILLE DE PIKINE","GUINAW RAIL SUD","SOTRAC I",68,163,561,517,1078
DAKAR,PIKINE,"VILLE DE PIKINE","GUINAW RAIL SUD","SOTRAC II",98,298,823,778,1601
DAKAR,PIKINE,"VILLE DE PIKINE","THIAROYE SUR MER","CHEIKH SOW",54,117,495,466,961
DAKAR,PIKINE,"VILLE DE PIKINE","THIAROYE SUR MER","MANDIAYE DIOP",204,624,1834,1627,3461
DAKAR,PIKINE,"VILLE DE PIKINE","THIAROYE SUR MER","CITE OUSMANE FALL",157,224,805,763,1568
DAKAR,PIKINE,"VILLE DE PIKINE","THIAROYE SUR MER","CITE SOCABEG ET ALIZE",363,694,1760,1852,3612
DAKAR,PIKINE,"VILLE DE PIKINE","THIAROYE SUR MER",FALLENE,45,106,628,602,1230
DAKAR,PIKINE,"VILLE DE PIKINE","THIAROYE SUR MER","IBRAHIMA NDAO",211,406,1487,1360,2847
DAKAR,PIKINE,"VILLE DE PIKINE","THIAROYE SUR MER","IBRAHIMA NGOM",137,215,1234,1145,2379
DAKAR,PIKINE,"VILLE DE PIKINE","THIAROYE SUR MER","LEYE DJITE",121,191,1065,1038,2103
DAKAR,PIKINE,"VILLE DE PIKINE","THIAROYE SUR MER","MACOUMBA SYLLA",161,313,1506,1408,2914
DAKAR,PIKINE,"VILLE DE PIKINE","THIAROYE SUR MER","ORYX 3 (MAME MATAR DIA)",107,222,790,722,1512
DAKAR,PIKINE,"VILLE DE PIKINE","THIAROYE SUR MER","MOR LAYE SENE (SENENE)",113,276,1092,991,2083
DAKAR,PIKINE,"VILLE DE PIKINE","THIAROYE SUR MER","NGAGNE DIAW",143,369,962,835,1797
DAKAR,PIKINE,"VILLE DE PIKINE","THIAROYE SUR MER",NIAGA,27,63,277,262,539
DAKAR,PIKINE,"VILLE DE PIKINE","THIAROYE SUR MER","ORYX 1 (MEDINA NIANG)",183,355,1209,1055,2264
DAKAR,PIKINE,"VILLE DE PIKINE","THIAROYE SUR MER","SAFCO 1",119,168,405,474,879
DAKAR,PIKINE,"VILLE DE PIKINE","THIAROYE SUR MER","SAFCO 2",87,113,286,338,624
DAKAR,PIKINE,"VILLE DE PIKINE","THIAROYE SUR MER",SANTHIABA,81,161,809,809,1618
DAKAR,PIKINE,"VILLE DE PIKINE","THIAROYE SUR MER",SAPI,126,182,496,569,1065
DAKAR,PIKINE,"VILLE DE PIKINE","THIAROYE SUR MER","THIAROYE BAGDAD",274,490,1514,1535,3049
DAKAR,PIKINE,"VILLE DE PIKINE","THIAROYE SUR MER","CITE DPV",49,65,174,207,381
DAKAR,PIKINE,"VILLE DE PIKINE","THIAROYE SUR MER","CITE NESTLE AZUR",67,116,342,376,718
DAKAR,PIKINE,"VILLE DE PIKINE","THIAROYE SUR MER","CITE PAPA GUEYE KHAR",135,260,836,840,1676
DAKAR,PIKINE,"VILLE DE PIKINE","THIAROYE SUR MER","CITE RST",341,574,1729,1808,3537
DAKAR,PIKINE,"VILLE DE PIKINE","THIAROYE SUR MER",FASS,64,129,450,489,939
DAKAR,PIKINE,"VILLE DE PIKINE","THIAROYE SUR MER","FASS 2",29,82,337,312,649
DAKAR,PIKINE,"VILLE DE PIKINE","THIAROYE SUR MER",MARENE,44,87,437,369,806
DAKAR,PIKINE,"VILLE DE PIKINE","THIAROYE SUR MER",MBATAL,145,298,973,948,1921
DAKAR,PIKINE,"VILLE DE PIKINE","THIAROYE SUR MER","MBATAL KEUR NGADIEL",43,67,237,268,505
DAKAR,PIKINE,"VILLE DE PIKINE","THIAROYE SUR MER","NDAKHTE NDIAYE",41,112,729,550,1279
DAKAR,PIKINE,"VILLE DE PIKINE","THIAROYE SUR MER","NDALOUM NIANG",102,198,836,765,1601
DAKAR,PIKINE,"VILLE DE PIKINE","THIAROYE SUR MER",NDIOBENE,14,63,334,297,631
DAKAR,PIKINE,"VILLE DE PIKINE","THIAROYE SUR MER",NGUEYENE,33,124,601,567,1168
DAKAR,PIKINE,"VILLE DE PIKINE","THIAROYE SUR MER","NIANGUE 1",29,62,366,352,718
DAKAR,PIKINE,"VILLE DE PIKINE","THIAROYE SUR MER","NIANGUE 2",50,236,641,624,1265
DAKAR,PIKINE,"VILLE DE PIKINE","THIAROYE SUR MER","ORYX 2 (MEDINA NIANG)",91,185,667,627,1294
DAKAR,PIKINE,"VILLE DE PIKINE","THIAROYE SUR MER","SEPCO I",123,143,378,429,807
DAKAR,PIKINE,"VILLE DE PIKINE","THIAROYE SUR MER","SEPCO II",102,137,364,395,759
DAKAR,PIKINE,"VILLE DE PIKINE","THIAROYE SUR MER","USINE (VIEUX THIANE)",138,409,1033,981,2014
DAKAR,PIKINE,"VILLE DE PIKINE","THIAROYE SUR MER","USINE COTONNIERE CAP VERT",133,296,895,816,1711
DAKAR,PIKINE,"VILLE DE PIKINE","THIAROYE SUR MER","ZONE INDUSTRIELLE",15,23,89,106,195
DAKAR,PIKINE,"VILLE DE PIKINE","TIVAOUANE DIACKSAO","CITE NALA",116,236,1041,944,1985
DAKAR,PIKINE,"VILLE DE PIKINE","TIVAOUANE DIACKSAO","DIACKSAO I",206,604,1836,1578,3414
DAKAR,PIKINE,"VILLE DE PIKINE","TIVAOUANE DIACKSAO","DIACKSAO II",191,423,1593,1456,3049
DAKAR,PIKINE,"VILLE DE PIKINE","TIVAOUANE DIACKSAO","DIACKSAO WALO",103,160,796,757,1553
DAKAR,PIKINE,"VILLE DE PIKINE","TIVAOUANE DIACKSAO","DIAMAGUENE II",113,242,867,871,1738
DAKAR,PIKINE,"VILLE DE PIKINE","TIVAOUANE DIACKSAO","LANSAR I",250,629,2220,1934,4154
DAKAR,PIKINE,"VILLE DE PIKINE","TIVAOUANE DIACKSAO","LANSAR III",219,485,1740,1563,3303
DAKAR,PIKINE,"VILLE DE PIKINE","TIVAOUANE DIACKSAO","MEDINA MARENE I",222,543,1717,1594,3311
DAKAR,PIKINE,"VILLE DE PIKINE","TIVAOUANE DIACKSAO","WAKHINANE I",300,707,2417,2428,4845
DAKAR,PIKINE,"VILLE DE PIKINE","TIVAOUANE DIACKSAO","WAKHINANE IV",84,160,649,555,1204
DAKAR,PIKINE,"VILLE DE PIKINE","TIVAOUANE DIACKSAO","DIAMAGUENE I",142,304,977,925,1902
DAKAR,PIKINE,"VILLE DE PIKINE","TIVAOUANE DIACKSAO","FASS DIACKSAO",183,434,1394,1241,2635
DAKAR,PIKINE,"VILLE DE PIKINE","TIVAOUANE DIACKSAO",TIVAOUANE,279,740,2476,2280,4756
DAKAR,PIKINE,"VILLE DE PIKINE","TIVAOUANE DIACKSAO","WAKHINANE II",200,517,1540,1503,3043
DAKAR,PIKINE,"VILLE DE PIKINE","DIAMAGUENE SICAP MBAO",AINOUMADY,343,599,2478,2467,4945
DAKAR,PIKINE,"VILLE DE PIKINE","DIAMAGUENE SICAP MBAO","HAMDALLAH IV",302,501,1984,1874,3858
DAKAR,PIKINE,"VILLE DE PIKINE","DIAMAGUENE SICAP MBAO","HAMDALLAH V",164,283,1190,1208,2398
DAKAR,PIKINE,"VILLE DE PIKINE","DIAMAGUENE SICAP MBAO",ARAFAT,49,159,362,314,676
DAKAR,PIKINE,"VILLE DE PIKINE","DIAMAGUENE SICAP MBAO","CITE MILLIONNAIRE",175,396,1070,994,2064
DAKAR,PIKINE,"VILLE DE PIKINE","DIAMAGUENE SICAP MBAO","CITE NELSON MANDELA",112,285,653,585,1238
DAKAR,PIKINE,"VILLE DE PIKINE","DIAMAGUENE SICAP MBAO","CITE PASTEUR",308,697,1942,1989,3931
DAKAR,PIKINE,"VILLE DE PIKINE","DIAMAGUENE SICAP MBAO","CITE SICA DE MBAO (CITE ALIOU SOW)",176,236,625,718,1343
DAKAR,PIKINE,"VILLE DE PIKINE","DIAMAGUENE SICAP MBAO","CITE SOBOA",54,140,445,348,793
DAKAR,PIKINE,"VILLE DE PIKINE","DIAMAGUENE SICAP MBAO","DAROU MINAM I (DAROU RAHMANE I A)",183,375,1389,1318,2707
DAKAR,PIKINE,"VILLE DE PIKINE","DIAMAGUENE SICAP MBAO","DAROU MINAM II",86,214,699,627,1326
DAKAR,PIKINE,"VILLE DE PIKINE","DIAMAGUENE SICAP MBAO","DAROU RAHMANE II B",304,588,2201,1983,4184
DAKAR,PIKINE,"VILLE DE PIKINE","DIAMAGUENE SICAP MBAO","DAROU RAHMANE III A",166,413,1431,1295,2726
DAKAR,PIKINE,"VILLE DE PIKINE","DIAMAGUENE SICAP MBAO","DIACKSAO II GOUYE SAPOUT",219,511,1863,1865,3728
DAKAR,PIKINE,"VILLE DE PIKINE","DIAMAGUENE SICAP MBAO","DIAMAGUENE MAREGE (SAMBA DRAME)",162,316,1213,1176,2389
DAKAR,PIKINE,"VILLE DE PIKINE","DIAMAGUENE SICAP MBAO","FASS MBAO I",110,181,663,675,1338
DAKAR,PIKINE,"VILLE DE PIKINE","DIAMAGUENE SICAP MBAO","FASS MBAO II",190,331,1218,1167,2385
DAKAR,PIKINE,"VILLE DE PIKINE","DIAMAGUENE SICAP MBAO","FASS MBAO III",155,364,1088,1041,2129
DAKAR,PIKINE,"VILLE DE PIKINE","DIAMAGUENE SICAP MBAO",FORA,82,143,522,521,1043
DAKAR,PIKINE,"VILLE DE PIKINE","DIAMAGUENE SICAP MBAO","LEONA DIAMAGUENE",100,248,906,815,1721
DAKAR,PIKINE,"VILLE DE PIKINE","DIAMAGUENE SICAP MBAO","MEDINA FASS MBAO",130,319,1212,1127,2339
DAKAR,PIKINE,"VILLE DE PIKINE","DIAMAGUENE SICAP MBAO","MEDINA MARENE II",189,444,1408,1357,2765
DAKAR,PIKINE,"VILLE DE PIKINE","DIAMAGUENE SICAP MBAO","MEDINATOUL MOUNAWARA",245,476,2053,1809,3862
DAKAR,PIKINE,"VILLE DE PIKINE","DIAMAGUENE SICAP MBAO","TOUBA MEDINATOUL RASSOUL (RTS)",187,346,961,908,1869
DAKAR,PIKINE,"VILLE DE PIKINE","DIAMAGUENE SICAP MBAO","MISSIRAH I",85,156,636,597,1233
DAKAR,PIKINE,"VILLE DE PIKINE","DIAMAGUENE SICAP MBAO","NASSOUROULAYE I",117,214,945,924,1869
DAKAR,PIKINE,"VILLE DE PIKINE","DIAMAGUENE SICAP MBAO","NASSOUROULAYE II",167,264,1033,1029,2062
DAKAR,PIKINE,"VILLE DE PIKINE","DIAMAGUENE SICAP MBAO","NASSOUROULAYE III A",153,245,1081,990,2071
DAKAR,PIKINE,"VILLE DE PIKINE","DIAMAGUENE SICAP MBAO","SAM SAM I A",102,191,765,752,1517
DAKAR,PIKINE,"VILLE DE PIKINE","DIAMAGUENE SICAP MBAO","SAM SAM I B",359,761,2817,2726,5543
DAKAR,PIKINE,"VILLE DE PIKINE","DIAMAGUENE SICAP MBAO","SAM SAM III",123,229,929,828,1757
DAKAR,PIKINE,"VILLE DE PIKINE","DIAMAGUENE SICAP MBAO","SAM SAM III C TAIF",82,169,578,515,1093
DAKAR,PIKINE,"VILLE DE PIKINE","DIAMAGUENE SICAP MBAO","SAM SAM III DAROU KHAFOR",75,158,629,451,1080
DAKAR,PIKINE,"VILLE DE PIKINE","DIAMAGUENE SICAP MBAO","SAM SAM NIMZATT",115,209,785,710,1495
DAKAR,PIKINE,"VILLE DE PIKINE","DIAMAGUENE SICAP MBAO","SICAP DAROUL IMANE",228,680,1982,1855,3837
DAKAR,PIKINE,"VILLE DE PIKINE","DIAMAGUENE SICAP MBAO","SICAP EXTENSION",220,576,1199,1322,2521
DAKAR,PIKINE,"VILLE DE PIKINE","DIAMAGUENE SICAP MBAO","SICAP MBAO (CITE OUVRIÈRE)",486,875,2800,2720,5520
DAKAR,PIKINE,"VILLE DE PIKINE","DIAMAGUENE SICAP MBAO","TAIF I",98,233,725,638,1363
DAKAR,PIKINE,"VILLE DE PIKINE","DIAMAGUENE SICAP MBAO","TAIF I SUD",80,158,565,487,1052
DAKAR,PIKINE,"VILLE DE PIKINE","DIAMAGUENE SICAP MBAO","TAIF III",72,143,477,502,979
DAKAR,PIKINE,"VILLE DE PIKINE","DIAMAGUENE SICAP MBAO","TOUBA DIAMAGUENE",88,160,717,614,1331
DAKAR,PIKINE,"VILLE DE PIKINE","DIAMAGUENE SICAP MBAO","TOUBA SAM SAM II",179,306,1625,1284,2909
DAKAR,PIKINE,"VILLE DE PIKINE","DIAMAGUENE SICAP MBAO","BABOU SALAM",109,274,919,793,1712
DAKAR,PIKINE,"VILLE DE PIKINE","DIAMAGUENE SICAP MBAO","CHEIKH ANTA",44,85,311,314,625
DAKAR,PIKINE,"VILLE DE PIKINE","DIAMAGUENE SICAP MBAO","CITE SABE",49,52,182,207,389
DAKAR,PIKINE,"VILLE DE PIKINE","DIAMAGUENE SICAP MBAO","CITE SOTRAC",195,493,1490,1391,2881
DAKAR,PIKINE,"VILLE DE PIKINE","DIAMAGUENE SICAP MBAO","DAROU RAHMANE A I",109,210,837,715,1552
DAKAR,PIKINE,"VILLE DE PIKINE","DIAMAGUENE SICAP MBAO","DAROU RAHMANE III B",112,287,1048,981,2029
DAKAR,PIKINE,"VILLE DE PIKINE","DIAMAGUENE SICAP MBAO","DAROU SALAM SAM SAM III",58,119,506,415,921
DAKAR,PIKINE,"VILLE DE PIKINE","DIAMAGUENE SICAP MBAO","DAROU SALAM SANT YALLA",322,694,2501,2310,4811
DAKAR,PIKINE,"VILLE DE PIKINE","DIAMAGUENE SICAP MBAO",DIMAT,99,165,771,742,1513
DAKAR,PIKINE,"VILLE DE PIKINE","DIAMAGUENE SICAP MBAO","KAOUSSARA MEDINA FASS MBAO",65,189,614,473,1087
DAKAR,PIKINE,"VILLE DE PIKINE","DIAMAGUENE SICAP MBAO","MAKATAL MOUKARAMA",194,438,1462,1451,2913
DAKAR,PIKINE,"VILLE DE PIKINE","DIAMAGUENE SICAP MBAO","MEDINA DIAMAGUENE",97,188,769,617,1386
DAKAR,PIKINE,"VILLE DE PIKINE","DIAMAGUENE SICAP MBAO","MEDINA KILOMETRES 16",181,377,1333,1189,2522
DAKAR,PIKINE,"VILLE DE PIKINE","DIAMAGUENE SICAP MBAO","MEDINA SAM SAM II",80,140,625,585,1210
DAKAR,PIKINE,"VILLE DE PIKINE","DIAMAGUENE SICAP MBAO","MEDINA SAM SAM III",80,158,609,572,1181
DAKAR,PIKINE,"VILLE DE PIKINE","DIAMAGUENE SICAP MBAO","MEDINA SAM SAM III C",191,291,1232,1148,2380
DAKAR,PIKINE,"VILLE DE PIKINE","DIAMAGUENE SICAP MBAO","MEDINATOUL SAM SAM III",84,157,576,497,1073
DAKAR,PIKINE,"VILLE DE PIKINE","DIAMAGUENE SICAP MBAO","MISSIRAH II TALLY MAME DIARRA",104,192,724,699,1423
DAKAR,PIKINE,"VILLE DE PIKINE","DIAMAGUENE SICAP MBAO","MOUSDALIFA MEDINA FASS MBAO",119,275,1008,950,1958
DAKAR,PIKINE,"VILLE DE PIKINE","DIAMAGUENE SICAP MBAO","NASSOUROULAYE III B",51,92,247,233,480
DAKAR,PIKINE,"VILLE DE PIKINE","DIAMAGUENE SICAP MBAO","SAM SAM II",236,459,1794,1735,3529
DAKAR,PIKINE,"VILLE DE PIKINE","DIAMAGUENE SICAP MBAO","SAM SAM III TOUBA KHAIRA",222,435,1722,1557,3279
DAKAR,PIKINE,"VILLE DE PIKINE","DIAMAGUENE SICAP MBAO","SAM SAM III ZONE 8",101,215,779,754,1533
DAKAR,PIKINE,"VILLE DE PIKINE","THIAROYE GARE","LA ROCHETTE A",288,679,2130,2062,4192
DAKAR,PIKINE,"VILLE DE PIKINE","THIAROYE GARE","KHEWEUL LA ROCHETTE B",128,413,1221,1086,2307
DAKAR,PIKINE,"VILLE DE PIKINE","THIAROYE GARE","DAROU SALAM I",86,223,679,655,1334
DAKAR,PIKINE,"VILLE DE PIKINE","THIAROYE GARE","FASS I",108,204,851,758,1609
DAKAR,PIKINE,"VILLE DE PIKINE","THIAROYE GARE","FASS II",67,146,520,520,1040
DAKAR,PIKINE,"VILLE DE PIKINE","THIAROYE GARE","HAMDALAHI III",228,504,1868,1760,3628
DAKAR,PIKINE,"VILLE DE PIKINE","THIAROYE GARE","HAMDALAHI III C",173,357,1171,1180,2351
DAKAR,PIKINE,"VILLE DE PIKINE","THIAROYE GARE","HAMDALAHI I",363,847,2845,2675,5520
DAKAR,PIKINE,"VILLE DE PIKINE","THIAROYE GARE",LAYENE,40,81,291,273,564
DAKAR,PIKINE,"VILLE DE PIKINE","THIAROYE GARE","PIKINI BOUGOU",156,369,1245,1247,2492
DAKAR,PIKINE,"VILLE DE PIKINE",MBAO,"AB GOKH (GRAND MBAO)",183,268,968,1010,1978
DAKAR,PIKINE,"VILLE DE PIKINE",MBAO,"ALDIANA (KEUR MBAYE FALL)",215,596,1476,1296,2772
DAKAR,PIKINE,"VILLE DE PIKINE",MBAO,BAOBAB,249,359,944,1051,1995
DAKAR,PIKINE,"VILLE DE PIKINE",MBAO,"BEAU SEJOUR",222,399,1260,1157,2417
DAKAR,PIKINE,"VILLE DE PIKINE",MBAO,"BENOU SANT YALLA",289,467,1601,1565,3166
DAKAR,PIKINE,"VILLE DE PIKINE",MBAO,"CITE ADJA MAREME DIOP MAKHTAR (PETIT MBAO)",146,203,600,660,1260
DAKAR,PIKINE,"VILLE DE PIKINE",MBAO,"CITE ALMAMY",45,73,172,221,393
DAKAR,PIKINE,"VILLE DE PIKINE",MBAO,"CITE ASECNA",218,303,847,923,1770
DAKAR,PIKINE,"VILLE DE PIKINE",MBAO,"CITE ASSURANCE ZAC MBAO",195,247,763,741,1504
DAKAR,PIKINE,"VILLE DE PIKINE",MBAO,"CITE BALICO",38,51,116,146,262
DAKAR,PIKINE,"VILLE DE PIKINE",MBAO,"CITE BOUGOUMA SECK",192,294,883,895,1778
DAKAR,PIKINE,"VILLE DE PIKINE",MBAO,"CITE ENVIRONNEMENT",84,135,380,400,780
DAKAR,PIKINE,"VILLE DE PIKINE",MBAO,"CITE FINANCE",58,73,234,272,506
DAKAR,PIKINE,"VILLE DE PIKINE",MBAO,"CITE FLAMBOYANT",236,362,1059,1150,2209
DAKAR,PIKINE,"VILLE DE PIKINE",MBAO,"CITE GABONAISE (COTOA,SPIS,FRIPERIE)",121,157,489,504,993
DAKAR,PIKINE,"VILLE DE PIKINE",MBAO,"CITE MANTOR DIOUF",92,108,300,347,647
DAKAR,PIKINE,"VILLE DE PIKINE",MBAO,"CITE NDEYE MARIE",307,388,1104,1319,2423
DAKAR,PIKINE,"VILLE DE PIKINE",MBAO,"CITE PENITENCE (IDEN, ETRANGERE, KHALIFA HOLDING MBAO)",107,141,362,464,826
DAKAR,PIKINE,"VILLE DE PIKINE",MBAO,"CITE PERSONNEL FORCE FRANCAISE DU CAP VERT",83,113,334,412,746
DAKAR,PIKINE,"VILLE DE PIKINE",MBAO,"CITE POLICE",130,229,650,680,1330
DAKAR,PIKINE,"VILLE DE PIKINE",MBAO,"CITE PORT (SATS)",78,115,330,310,640
DAKAR,PIKINE,"VILLE DE PIKINE",MBAO,"CITE POSTE (KEUR MBAYE FALL)",154,249,862,843,1705
DAKAR,PIKINE,"VILLE DE PIKINE",MBAO,"CITE PROMOCAP",274,410,1068,1174,2242
DAKAR,PIKINE,"VILLE DE PIKINE",MBAO,"CITE RTS",62,105,289,336,625
DAKAR,PIKINE,"VILLE DE PIKINE",MBAO,"CITE SABA",162,201,760,772,1532
DAKAR,PIKINE,"VILLE DE PIKINE",MBAO,"CITE SAFCO",139,172,471,545,1016
DAKAR,PIKINE,"VILLE DE PIKINE",MBAO,"CITE SATAR ZAC MBAO",70,74,201,268,469
DAKAR,PIKINE,"VILLE DE PIKINE",MBAO,"CITE SENELEC",24,57,133,153,286
DAKAR,PIKINE,"VILLE DE PIKINE",MBAO,"CITE SERIGNE MANSOUR SY",288,458,1214,1400,2614
DAKAR,PIKINE,"VILLE DE PIKINE",MBAO,"CITE SHELL",42,55,176,200,376
DAKAR,PIKINE,"VILLE DE PIKINE",MBAO,"CITE SIPRES V",290,302,754,930,1684
DAKAR,PIKINE,"VILLE DE PIKINE",MBAO,"CITE SODEVA",27,33,105,132,237
DAKAR,PIKINE,"VILLE DE PIKINE",MBAO,"CITE SONES",23,24,70,72,142
DAKAR,PIKINE,"VILLE DE PIKINE",MBAO,"CITE SUDES (IBA NDIAYE DIADJ AK LIKEUWEUR)",149,192,568,620,1188
DAKAR,PIKINE,"VILLE DE PIKINE",MBAO,"CITE ICS TAIBA",65,87,284,304,588
DAKAR,PIKINE,"VILLE DE PIKINE",MBAO,"DABAKH MALICK",666,1098,3014,3217,6231
DAKAR,PIKINE,"VILLE DE PIKINE",MBAO,"DAL DIAM",141,228,771,839,1610
DAKAR,PIKINE,"VILLE DE PIKINE",MBAO,"DAROU SALAM (KEUR MBAYE FALL)",133,274,807,732,1539
DAKAR,PIKINE,"VILLE DE PIKINE",MBAO,"DAROU SALAM I (KEUR MBAYE FALL)",272,602,1953,1690,3643
DAKAR,PIKINE,"VILLE DE PIKINE",MBAO,"DAROU SALAM II (KEUR MBAYE FALL)",168,320,1018,1006,2024
DAKAR,PIKINE,"VILLE DE PIKINE",MBAO,"DAROU SALAM RUE X",381,648,2193,2068,4261
DAKAR,PIKINE,"VILLE DE PIKINE",MBAO,"DIAMAGUENE (KEUR MBAYE FALL)",111,260,756,715,1471
DAKAR,PIKINE,"VILLE DE PIKINE",MBAO,"DIAMAGUENE APRES PEAGE",177,248,761,704,1465
DAKAR,PIKINE,"VILLE DE PIKINE",MBAO,"DJANATOU FIRDAWSI (KEUR MBAYE FALL)",153,423,1079,1093,2172
DAKAR,PIKINE,"VILLE DE PIKINE",MBAO,"EX SONES",84,136,373,370,743
DAKAR,PIKINE,"VILLE DE PIKINE",MBAO,"KEUR MBAYE FALL EXTENSION SUD (KEUR MBAYE FALL)",286,525,1960,1762,3722
DAKAR,PIKINE,"VILLE DE PIKINE",MBAO,"FASS (GRAND MBAO)",97,168,654,709,1363
DAKAR,PIKINE,"VILLE DE PIKINE",MBAO,"GRAND MBAO EXTENSION B (GRAND MBAO)",236,332,1132,1144,2276
DAKAR,PIKINE,"VILLE DE PIKINE",MBAO,"KAMB GARAGE",24,31,175,178,353
DAKAR,PIKINE,"VILLE DE PIKINE",MBAO,"KAMB MOSQUEE",31,50,253,233,486
DAKAR,PIKINE,"VILLE DE PIKINE",MBAO,"KAMB NORD (KAMB FALL)",62,109,461,439,900
DAKAR,PIKINE,"VILLE DE PIKINE",MBAO,"KAMB OUEST",37,65,279,255,534
DAKAR,PIKINE,"VILLE DE PIKINE",MBAO,"KAMB PEULH",53,94,444,377,821
DAKAR,PIKINE,"VILLE DE PIKINE",MBAO,"KAOSSARA MBAO GARE RUE X",469,676,2631,2527,5158
DAKAR,PIKINE,"VILLE DE PIKINE",MBAO,"KEUR MBAYE FALL I",93,130,617,621,1238
DAKAR,PIKINE,"VILLE DE PIKINE",MBAO,KHEWEUL,173,313,809,936,1745
DAKAR,PIKINE,"VILLE DE PIKINE",MBAO,"LAMSAR (GRAND MBAO)",55,75,302,308,610
DAKAR,PIKINE,"VILLE DE PIKINE",MBAO,"LOTISSEMENT BAOBAB",391,601,1400,1706,3106
DAKAR,PIKINE,"VILLE DE PIKINE",MBAO,"MEDINA MBAO CONCORDE (KEUR MBAYE FALL)",167,251,795,744,1539
DAKAR,PIKINE,"VILLE DE PIKINE",MBAO,"PETIT MBAO PEULH (PETIT MBAO)",65,124,366,366,732
DAKAR,PIKINE,"VILLE DE PIKINE",MBAO,"MBAO VILLENEUVE",422,489,1267,1335,2602
DAKAR,PIKINE,"VILLE DE PIKINE",MBAO,"MEDINA MBAO GARE (KEUR MBAYE FALL)",454,564,2218,2256,4474
DAKAR,PIKINE,"VILLE DE PIKINE",MBAO,"MEDINE (GRAND MBAO)",98,185,716,756,1472
DAKAR,PIKINE,"VILLE DE PIKINE",MBAO,"NDIOBENE (GRAND MBAO)",116,175,830,769,1599
DAKAR,PIKINE,"VILLE DE PIKINE",MBAO,"NDOYENE KAW",81,112,470,463,933
DAKAR,PIKINE,"VILLE DE PIKINE",MBAO,"NDOYENE SOUF (GRAND MBAO)",40,85,451,514,965
DAKAR,PIKINE,"VILLE DE PIKINE",MBAO,"PETIT MBAO EXTENTION",336,529,1505,1662,3167
DAKAR,PIKINE,"VILLE DE PIKINE",MBAO,"SANT YALLA (KEUR MBAYE FALL)",171,261,934,934,1868
DAKAR,PIKINE,"VILLE DE PIKINE",MBAO,"SDV (MIXTE)",181,247,807,827,1634
DAKAR,PIKINE,"VILLE DE PIKINE",MBAO,"SERIGNE MANSOUR SY",129,221,830,788,1618
DAKAR,PIKINE,"VILLE DE PIKINE",MBAO,"SEYDOU NOUROU TALL (KEUR MBAYE FALL)",157,302,1025,992,2017
DAKAR,PIKINE,"VILLE DE PIKINE",MBAO,"THIEKENE (GRAND MBAO)",21,43,204,181,385
DAKAR,PIKINE,"VILLE DE PIKINE",MBAO,"TOUBA GUEDE (KEUR MBAYE FALL)",112,212,814,777,1591
DAKAR,PIKINE,"VILLE DE PIKINE",MBAO,"TOUBA TAIF (KEUR MBAYE FALL)",277,663,1941,1882,3823
DAKAR,PIKINE,"VILLE DE PIKINE",MBAO,"ZONE INDUSTRIELLE (FORET CLASSEE DE MBAO)",10,10,29,48,77
DAKAR,PIKINE,"VILLE DE PIKINE",MBAO,"AB GOKH EXTENSION (GRAND MBAO)",157,243,755,815,1570
DAKAR,PIKINE,"VILLE DE PIKINE",MBAO,"BAYAL EXTENSION (PETIT MBAO)",23,49,198,213,411
DAKAR,PIKINE,"VILLE DE PIKINE",MBAO,"BRAS DE MER",98,155,569,575,1144
DAKAR,PIKINE,"VILLE DE PIKINE",MBAO,"CITE BAYE NIASS",65,179,253,313,566
DAKAR,PIKINE,"VILLE DE PIKINE",MBAO,"CITE CORA FALL",19,27,74,84,158
DAKAR,PIKINE,"VILLE DE PIKINE",MBAO,"CITE LA CLEMENCE",121,144,425,504,929
DAKAR,PIKINE,"VILLE DE PIKINE",MBAO,"CITE SAFCO (CITE YAYE SOKHNA)",69,80,197,248,445
DAKAR,PIKINE,"VILLE DE PIKINE",MBAO,"CITE SICAP",33,54,124,172,296
DAKAR,PIKINE,"VILLE DE PIKINE",MBAO,"CITE SIDAK",120,157,472,588,1060
DAKAR,PIKINE,"VILLE DE PIKINE",MBAO,"CITE TAWFEKH",44,50,166,199,365
DAKAR,PIKINE,"VILLE DE PIKINE",MBAO,"EXTENSION C (KEUR MBAYE FALL)",249,457,1463,1521,2984
DAKAR,PIKINE,"VILLE DE PIKINE",MBAO,"FASS (PETIT MBAO)",32,50,184,197,381
DAKAR,PIKINE,"VILLE DE PIKINE",MBAO,"FASS EXTENSION",41,86,358,261,619
DAKAR,PIKINE,"VILLE DE PIKINE",MBAO,"GRAND MBAO EXTENSION EST (GRAND MBAO)",328,504,1563,1724,3287
DAKAR,PIKINE,"VILLE DE PIKINE",MBAO,"KAMB EXTENSION",229,391,1237,1272,2509
DAKAR,PIKINE,"VILLE DE PIKINE",MBAO,"MBAO PEULH",34,46,173,151,324
DAKAR,PIKINE,"VILLE DE PIKINE",MBAO,"MBAO PEULH EXTENSION (PETIT MBAO)",35,68,209,205,414
DAKAR,PIKINE,"VILLE DE PIKINE",MBAO,"MEDINATOUL MOUNAWARA",209,327,1156,1267,2423
DAKAR,PIKINE,"VILLE DE PIKINE",MBAO,"MISSION FRANCAISE DE COOPERATION",76,129,403,391,794
DAKAR,PIKINE,"VILLE DE PIKINE",MBAO,"MOSQUEE II",38,55,243,253,496
DAKAR,PIKINE,"VILLE DE PIKINE",MBAO,"NIARY GOUYE (GRAND MBAO)",50,86,409,400,809
DAKAR,PIKINE,"VILLE DE PIKINE",MBAO,"QUARTIER MOUSTAPHA SALL (KEUR MBAYE EXTENSION)",248,392,1363,1339,2702
DAKAR,PIKINE,"VILLE DE PIKINE",MBAO,"SERIGNE MANSOUR SY BIS (GRAND MBAO)",89,125,407,465,872
DAKAR,PIKINE,"VILLE DE PIKINE",MBAO,"THIEKENE (PETIT MBAO)",22,36,138,156,294
DAKAR,PIKINE,"VILLE DE PIKINE",MBAO,TONGHOR,18,28,122,145,267
DAKAR,PIKINE,"VILLE DE PIKINE",MBAO,"TOURNAL (PETIT MBAO)",17,26,129,142,271